*а:	a, и, же, но, как только, чтобы, напротив, да;
*a bo:	или, до, ли, ибо, так как, либо, когда бы, если бы, иначе, разве;
*a by:	если бы, чтобы, лишь бы, как будто, как бы, дабы, только бы, хоть бы, если, либо, то есть, чтобы только;
*a čе/*а či:	после, и затем, ако, хотя, или, ли, как, если, потому что, что, хоть, но, несмотря на то, сколь, насколько, вот еще, как бы не так, еще что, авось;
*а jьno?/*a оnо:	потому что, да но, кроме, и, но, а, давно, но, однако, теперь, да, тут, там, ну да, конечно, итак, вот, так что, даже, а вот, а вместо этого, или, а то, только;
*а lе:	но, ну, однако, между тем, впрочем;
*а li:	разве, но, если, или, однако, ли, конечно, либо, же, ужели, по крайней мере, так что, даже;
*a ni:	ни, и ни, даже и не;
*a si/*a se:	примерно, возможно, может быть, и, ась;
*а ti:	чтобы, дабы, пусть, да, давай;
*a to:	a выходит, а оказывается, что, пусть, да, а как же, как иначе, да, так, а, но, а не то, а между тем, кроме того, еще;
*а že:	до тех пор, пока, до, что, чтобы, даже, вот, как только, так что, если, ли, тем более, ан вот, инда, напротив, между тем, ведь, как будто, точно, словно, а ведь, но, однако, между тем как, оказывается, возможно, вероятно, или, неужели, так что даже, а, но вот, что даже, пока даже, и вот, как;
*аblо:	яблоко, яблоня
*ablonevъjь/*ablonovъjь:	яблоневый, сделанный из Яблонового дерева, свойственный принадлежащий яблоне;
*ablonica/*abolnica?:	яблоня;
*ablonišče/*abolnišče:	яблоневый сад;
*аblоnь:	яблоня;
*ablonьjь:	яблоневый;
*ablonьje:	яблони;
*аblоnьnъjь/*аbolnьnъjь:	яблочный, яблоневый, Яблоновый, яблонный;
*аblъ:	яблоко, яблоня;
*ablъčьnъjь:	яблочный;
*аblъка:	яблоня, яблоко;
*аblъко:	яблоко, плод яблони;
*ablъkovъ(jь):	яблочный, яблоневый;
*аblъкъ:	яблоко;
*abolnovъ(jь):	платановый, тополиный, яблоневый;
*аbоlnъ:	платан, чинара, яблан, пирамидальный тополь;
*аbоlnь I:	яблоня;
*аbоlnь II:	болонь в дереве;
*abrĕdja:	плодовое дерево;
*abrĕdъ/*obrĕdъ:	садовые фрукты, сухие фрукты, фрукты;
*abrĕdь:	акрида;
*abrĕdьje:	саранча, акриды;
*abrędъ:	вид тополя;
*abrędъka:	сережки (на вербе, иве), гусята;
*abrędъkъ:	сережка (на орешнике, ольхе, сосне), весенняя гроздь винограда, цвет орешника, цвет ольхи, побег виноградной лозы;
*abrędь:	сережки, цвет (на дереве), вид тополя, тополь;
*abrędьje:	вид тополя;
*abьje:	сейчас же, тотчас;
*adati:	испытывать, исследовать;
*adera?:	сварливый, неуживчивый человек;
*aduxa:	кашель, удушье, чахотка;
*adušivъjь:	страдающий одышкой;
*adušь:	одышка, удушье;
*aglъjь/*jaglъjь:	тучная, черная почва, чернозем;
*agnevъjь?:	ягнячий;
*agnę:	ягненок, агнец,'козленок;
*agnędъ:	тополь, цвет, сережки (на деревьях);
*agnędъje:	тополя, чернотополье;
*agnętina:	ягнятина, мясо или шкурка ягненка;
*agnętjьjь:	ягнячий;
*agnica:	ягненок женского пола, суягная овца, молодая овца;
*agnidlo?:	ягнятник, время ягнения овец, место куда пригоняют овец ягниться, время окота овец, место где ягнятся овцы, загон;
*agniti(sę):	ягниться, давать приплод (об овце), рожать ягнят;
*agnьcь:	агнец, ягненок, барашек, (жертвенный) агнец;
*agoda:	 плод, ягода, земляника, клубника, щека, плод ежевики, оспа, щеки, черника, плод винограда, небольшой сочный плод кустарниковых или травянистых растений, мускулы на лицевых скулах, шелковица;
*agodica:	скула, щеки, ягодица (задняя мясистая часть тела, седалище, округлая половина этой части, сосок женской груди), щека;
*agodina?:	ягодина (название растения), куст земляники; 
*agodišče:	место где растут ягоды;
*agodъka, мн. *agodъky:	 скула, верхняя часть щеки, верхние скулы, скулы лица
*agodьje:	ягоды;
*agodьnica:	ягодница (название дерева), тутовое дерево, кушанье из земляники, сок из ягод, щека, щеки, скулы, собирающая ягоды;
*agodьnikъ:	ягода, земляника, куст земляники, тутовое дерево, ягодный огород, ягодное место, ягодное варенье, пастила, пирог, кустарник на котором родятся ягоды, земляника лесная, стебли кусты клубники или земляники;
*agodьnъjь:	ягодный, земляничный, черничный;
*agolvo?:	скотина убитая хищным зверем (медведем, волком), мертвечина, падаль;
*ajatъ(jь):	с яйцами (cum testiculis);
*aje:	яйцо, яичко;
*ajina:	яичная скорлупа;
*ajitъjь?:	овальный
*ajьce:	яйцо (птичье), яичко (testiculus)
*ajьčьjь:	яичный
*аjьčьnа:	яичница
*ajьčьnica:	праздничное кушанье из теста с крашеным яйцом посередине, яичница (из взбитых яиц, из поджаренных на сковороде яиц);
*ajьčьnikъ:	кушанье с яйцами, яичница, кушанье из яиц, железа на горле скотины, вид гриба;
*аjьčьnъjь:	яичный, из яиц;
*ajьko:	яйцо, яичко, пасхальное яйцо, круглая ягодка как плод растения;
*ajьno:	пузырь, плена, сорочка в коей иногда родятся младенцы;
*аjьnъjь:	яичный, овальный;
*ako/*jako?:	как, будто, если, хотя, поскольку, ли, когда, что, так что, чтобы, ибо, так как, так, как будто;
*alovĕti/*jalovĕti:	становиться бесплодным (о животном), быть оставаться бесплодным, яловеть (о корове: быть яловой, становиться яловой), оставаться бесплодной (о самке скота), оставаться невспаханной (о земле);
*alovę/*jalovę:	яловица, яловка, телка, телок;
*alovica/*jalovica:	яловица, бездетная женщина, глинистая почва, вид почвы красноватого цвета, неплодородная почва, трудно обрабатываемая, яловое животное , бесплодная земля, невспаханное поле, теленок, бесплодная самка животного (корова, коза, овца), телка, не телившаяся молодая корова, яловка, корова не дававшая приплода, нетель, несуягная овца, юница, телица не приносившая еще теленка;
*alovičina/*jalovičina:	телячья кожа, телятина, говядина;
*alovina/*jalovina:	яловая скотина (овцы, коровы), скотина которая не доится, молодой рогатый скот, лядо, запущенная, плохая земля, перелог, поле, засеваемое с промежутком в 2—3 года для повышения плодородия почвы, поле которое не успели обработать;
*aloviti(sę)/*jaloviti(sę):	скидывать (о животном), выхолащивать, кастрировать (барана), делать яловой (корову, кобылу, овцу), становиться яловой, бесплодной, делать бесплодной, земля отдыхает, лежит в пару;
*aloviznь/*jaloviznь:	молодой рогатый скот;
*alovъjь,*alovaja/*jalovъjь,*jalovaja:	не родящий, бесплодный (о земле, о скоте, о почве, растении), яловый, пустой, молодой (о скоте), недойный (о скоте), постный, несдобный (о тесте), неурожайный, сухой, нестельный, неплодный, неоплодотворенный, порожний, не подвергавшийся пахоте, заобложивший, молодая корова, нетель;
*аlоvъkа/*jalovъka:	телка, яловая овца или корова, телица, молодая корова, яловица, нетель, неплодная корова, яловка;
*аlоvъкъ?/*аlоvакъ?:	кладеный баран-вожак, кастрированное животное (бык, конь), бесплодный петух;
*аlоvьсь/*jаlоvьсь:	кладеный баран, бесплодное животное, бесплодный ствол, можжевельник, яловые овцы, терн;
*ama/*jama:	яма, воронка, пещера, углубление вырытое или образовавшееся в земле, углубление, нора, ров, могила, погреб;
*amo/*jamo:	сюда, куда;
*ара?:	надежда, ожидание;
*apadь:	тенистое место;
*apati:	наблюдать, созерцать, внимать;
*арьno?/*vаpьnо (см.):	известь;
*apьnъjь:	остроумный, находчивый;
*arębatъjь:	пестрый, рябой, полосатый;
*arębica:	куропатка, рябчик;
*arębika:	рябина;
*arębina:	мясо куропатки, плод рябины, рябина;
*аrębъ:	горная куропатка, куропатка (самец), рябина, вид тополя, рябчик;
*arębъjь:	пестрый, рябой (обычно о птицах);
*аrębъкъ:	рябчик, рябина (обыкновенная);
*аrębь:	куропатка;
*arębьje:	заросли, кусты рябины;
*аru:	если бы;
*arьmiti:	запрягать в ярмо, порабощать, угнетать;
*аrьmо:	ярмо для крупного рогатого скота, воловье ярмо, деревянный хомут для упряжки рабочего рогатого скота, воловья упряжь, ключица;
*аrьmъ:	ярмо, иго, перекладины на четырех столбах крепящие валяльное устройство, хомут;
*аrьmьnikъ:	деталь ярма, подъяремник, скот ходящий под ярмом;
*arьmьnъ(jь):	подъяремный, рабочий, впрягальный (скот, вол);
*asenica:	ясень;
*asenika:	ясень;
*asenikъ:	ясень, ясеневый лес;
*asenišče:	ясеневый лес;
*asenovъ(jь)/*asenevъ(jь):	ясеневый;
*asenъ/*asenь:	ясень;
*asenьcь:	название растения, ясеневый лес, ясенец (многолетнее травянистое растение с перистыми листьями как у ясеня);
*asenьje:	ясени, ясеневый лес, группа ясеней;
*asika:	осина, береза, вид тополя, осокорь, ясень;
*аsikъ:	осиновый лес;
*aska?:	углубление в земле, яма, лужа;
*askǫdь:	διεσταλμένους (расширенный?)
*askъ:	яма с водой, туннель, отверстие верши или рыбачьего кузова;
*askyni:	пещера;
*asokorъ/ь:	осокорь (растение Populus nigra);
*astrębica:	ястреб;
*astrębinъjь:	ястребов, ястребиный;
*astrębovъ:	ястребиный;
*astrębъ/*astrębь:	ястреб, коршун;
*astrębъkъ:	рябчик, ястребок, маленький ястреб;
*astrębьcь:	ястребок;
*astrębьjь/*astrębjь:	ястребиный;
*astriti:	зорко, пристально смотреть;
*astrǫbъ:	ястреб;
*astrъ:	ястреб;
*аščеlь?:	самец ящерицы;
*aščerica:	сыпь на языке во рту, зеленая ящерица, растение Imperatoria ostruthium, ящерица;
*аščеrъ:	ящерица, ангина, воспаление горла, ящер, змей, дракон, шероховатое воспаление языка у скота и лошадей, трещины по языку, рак языка, кожа обделанная сыпью, шершавая шагрень, болезнь языка у рогатого скота, саламандра, род мыши или сони;
*aščerъka:	ящерица, ящерка;
*aščerь:	выдра, уж, ящерица, личинка водяного жука;
*ašutь:	без причины, напрасно, даром, излишне, тщетность, ничтожность;
*ašutьnъjь:	тщеславный, пустой, тщетный;
*atje:	если, если бы, ли, хотя;
*atra:	огонь, блеск, пламя, костер (под открытым небом), зола, очаг, под печи на котором печется хлеб, кострище, пепел, жар, угли в костре, раскаленные угли с пламенем, место где горит или горел огонь, теплое место на печи, лежанка, пепел, искра из соломы;
*ava:	явь, действительность, бдение (в противоположность сну), наяву, показ, выставка, явление, дивное происшествие;
*avĕ:	явно, открыто, видно, ясно, известно, наяву, ясно, определенно;
*avida?:	черт;
*avidь?:	змея которая водится в тундрах;
*aviti(sę):	явить, открыть, показать, явиться, показаться, сообщить, окликнуть, передать, заявить, донести, появиться, объявить, вести за собой овец, заявить о себе, дать о себе знать, проявить, уведомлять, объявлять, делать явным, проявлять, являться, прибыть, обнаружить, предъявить;
*avo:	явно, открыто;
*avodь?:	струя, быстрина;
*avorina: 	древесина клена, яворовый лес, место в лесах, отведенное для пастьбы овец, яворовая кленовая поросль, дерево явор в поделках, явор, яворовое дерево;
*avorišče:	место где растут яворы, кленовый лес;
*avorovъ(jь):	кленовый, платановый, яворовый, принадлежащий явору, сделанный из явора;
*аvоrъ I:	клен, явор, белый клен, клены, чинар;
*аvоrъ II:	кладь сена?;
*avorьje:	кленовый лес, яворовый лес, яворы;
*avorьnica:	явор;
*аvоrьnikъ:	сорт виноградной лозы, майский жук, яворовый лес;
*аvоrьnъ(jь):	яворовый, яворный;
*аvъ:	проявление, свет, ясность, явность, в полном, здравом уме, в бодрствующем состоянии, извещение, уведомление, сообщение;
*аvъkа:	курица несущаяся впервые, вид пошлины, явка, рубка леса на продажу;
*аvь:	явь, бдение, реальная действительность в противоположность сну (бреду, мечте);
*аvьnъ(jь):	явный, очевидный, открытый, публичный, общеизвестный, общественный, ясный, видимый, видный, известный;
*azica:	плотва, шерешпер, язь;
*аzъ:	я;
*аzъкъ/*аzькъ:	рыба елец, малый шерех;
*аzь:	плотва, язь, бычок, шерешпер, пресноводная рыба из семейства карпов;
*azьnĕnъjь:	кожаный;
*аzьnо:	кожа;
*aževina?:	отходы при дублении кож, сердцевина тыквы, густой мох на деревьях и сырых стенах;
*ba:	да, поистине, ей-ей, даже, больше того, вот, ага, еще бы, конечно, ну, ба, вишь, видишь, а вот, да нет, даже, да и, наоборот, как раз;
*baba:	бабушка, повивальная бабка, пестунья, воспитательница, старуха, теща, пленка в которой появляется на свет ребенок, колбаса из толстой свиной кишки начиненной мясом, пеликан, хищная птица нападающая на кур, повитуха, акушерка, крупная дикорастущая ягода, старое дерево, отверстие в котором ходит ось мельничного жернова, детская игра, деревянная ступица оси мельничного жернова, кормилица, жена, свекровь, тетка, пчелиная матка, божья коровка, самый крупный табачный лист, стропило, балка, опора моста, опора веретена верхнего мельничного жернова, рычаг, подъемная стрела, путевой межевой знак, круглый камешек, изделие из теста (пирожное или булка круглой формы), название разных видов рыб и морских животных, баба, взрослая женщина, гайка, замужняя женщина, разновидность облаков, пугало, бабка с материнской стороны, мать, тетка матери или отца, самка животного, мать отца или матери, ворожея, тяжелый молот, болванка, гиря разного устройства, треног с железным наверху шпилем, на который насаживают воробы, прибор для свивания ниток состоящий из тренога и вращающегося на нем креста со вставленными на его концах веретенами, синяя или зеленая стрекоза, устарелая бесплодная пчелиная матка, моль, бабочка, рыба подкаменщик, род высокого кулича из очень сдобного теста выпекаемого в цилиндрических формах, булка из пшеничной муки имеющая цилиндрическую форму, оладья, лепешка, знахарка, ворожея, нищая, рыба бычек, головач, колода, чурбан с рукоятями для вбивания свай или утрамбовки земли, деревянная колода с полукруглыми выемками для бревен или с ручками которую ставят в сани при перевозке бревен, задняя часть саней, большой шарообразный комок горшечной глины образованный для перевозки глины с места добывания в мастерскую горшечника, трясина, сойка, вид кушанья из теста;
*baba ęga:	баба-яга, злая волшебница и людоедка;
*baba rǫga?:	мифическое существо которым пугают детей;
*bаbаkъ:	птица цапля, растение медвежье ухо, бабник, дикий шалфей, вошь, муж повитухи, страшилище пожирающее детей, женатый раздевуля, застенчивый женатый человек, любитель ухаживать за женщинами
*babĕti:	бабиться, становиться старой бабой, делаться женоподобным, бабиться, изнеживаться, набрякать, отекать, сморщиваться от долгого пребывания в воде (о человеческом теле);
*babiса:	куделя, горсть дурного льна, блона, железа, свиной пузырь, начиненный мясом, пучок мелкого недоброкачественного волокнассвиной желудок, неразвившаяся больная слива, острицы у детей, старуха, старушка, бабушка, акушерка, повивальная бабка, насекомое, вид морского рака, название ряда растений, стебель, наковаленка (брусок) для отбивки кос, столб в постройке, злые духи преследующие маленьких детей, родильная лихорадка, обряд поминовения, самка мелких животных, рыба, белый гриб, вид груши, шелуха, кочерыжка (кукурузы), гайка, крышка, копна, старушка-мать, повитуха, бабы, бабье, бабенка, женщина средних лет, молодая женщина недавно вышедшая замуж, распутная женщина, баба, старуха, растение, боль, колики в животе;
*bаbinъ:	принадлежащий бабе, бабушке, первые дни после родов и связанные с этим обычаи, старушечий, повитухин, бабкин, принадлежащий старухе или повивальной бабке, старухин, бабин, бабий, бабушкин;
*babiti:	помогать при родах, рожать, быть повитухой, быть акушеркой, бабить, быть повивальной бабкой, повивать, принимать, лекарить, знахарить, принимать детей;
*babitjь:	виноградная лоза плодоносящая разновидностью черного винограда, бабий угодник, прихвостень, птица пеликан, бабник, неженка, самец стрекозы;
*bablati sę:	пачкаться, копаться в чем-либо, перемешивать, путать, возиться, полоскать, мочить в воде, копаться руками в чем-либо (жидком, мягком, например в тесте);
*baboniti/*babuniti:	говорить густым гортанным голосом, бубнить, греметь, гудеть, бесцельно ходить туда-сюда (особенно в потемках), бестолково искать что-либо, мотаться, колдовать, говорить громко но невнятно, гадать, предсказывать что-нибудь, ворожить;
*bаbоnъ/*bаbunъ/*bаbоnа:	тот у кого морщинистое лицо, богумил, член еретической секты в древней Болгарии, человек с морщинистым лицом, женщина со злыми глазами, мужчина похожий на бабу, старик, суеверие, наваждение, чары, колдовство, ворожба, болтовня о чудесах и вера в них;
*babotati:	издавать гул, стучать зубами от холода страха или лихорадки, болтать;
*babrati(sę):	возиться, рыться, канителиться, копаться (руками) в чем-либо, пачкать, делать плохо неумело, трогать, пачкаться, медленно и долго делать, загрязнять, плохо делать, рыть, разрывать, брать, захватывать, перебирать, приводить в беспорядок, говорить о чем-либо без толку без смысла, плескаться в воде, перебирать грязь песок, лезть вверх, беспорядочно двигать ногами (о ребенке), хватать, схватывать, говорить невнятно или невразумительно, пачкать, марать, выискивать что получше (о еде), копаться в нечистоте, заниматься грязной работой, болтать о чем угодно, морщиться;
*babriti(sę):	пачкать, пачкаться, мараться;
*babrotati:	пачкаться, возиться, шлепать, плескать(ся);
*babrotъ:	плеск;
*babrovъjь?:	бобровый;
*babuxa:	закутанная женщина, бабка, старуха, прабабка, повивальная бабка, женщина, баба;
*babura:	зеленый сладкий перец (круглом формы), крупная игла, овца с плохими зубами, вид маленькой рыбки, червяк, насекомое, какой-то рак, нарост, шишка, часть дверного запора, вид жабы , божья коровка, жаба, растение, коробка, червь, сережки вербы, рыба, бабочка, особый род мелкой рыбы, чашка, свинячьи лодыжки, маленькие игорные бабки, старуха, старая баба (презр.), бабища;
*bаburъ:	улитка, гриб строчок, обыкновенный ерш;
*babuša:	баба, старуха (грубо), коробка, червь, бабушка, глупая баба, закутанная баба, старушка, гусь, гусыня, название растения, бабка;
*babušьka:	бабушка, старуха, больная овца (с большим животом), кокон, рыба, какое-то растение, вид лесной травы с широкими мшистыми листьями которую очень любят свиньи, вид бурьяна с округлыми мшистыми листьями, ослабевшее животное, выродившиеся плоды сливы, сладкий перец, крупная игла, вид небольшой пузатой рыбки, насекомое, шишка, орешек, дубовый орешек, червь определенного вида, старушка, гусыня, мать-и-мачеха, зубчатые кружева, мать отца или матери, пожилая женщина, повитуха, оспина, всякая болячка у детей, пятна в натуральной оспе, игрушки;
*bаbъkа:	старая мелкая монета, раковина которая идет на ожерелья, пуговица (из морской раковины), золотая монета, самка дикой свиньи, глиняный свисток, зоб, глотка, гортань, горло, свинка (болезнь), шишка, опухоль , ком, старинная монета, подпорка, наковаленка для отбивки косы, перекладина, седельная лука, груда битого камня для поддержания дороги в исправном состоянии, вид морской рыбы, название различных мелких животных и паразитов, растение, пучок шерсти, яма, старушка, бабка, кукла, кости ног у телят и овец, баба, повитуха, знахарка, изделие из теста, жук, стебель, пенек или корень, наковаленка, брусок для отбивки косы (серпа), железная петля для крючка на двери, старушка, небольшое темное облачко, старое дерево, бесценок, старушка-мать, петля на одежде, железная щеколда, пучок чесаного льна, углубление в конце или на боку вареного яйца, пчела, повивальная бабка, надкопытный сустав ноги у животных, кость этого сустава, ящерица, белый гриб, растение попутник подорожник, бабочка, насекомое, опора, столбик, стрекоза, игральная кость из ступни животного, узенький круглый ремешок связывающий две основные части цепа, кушанье из запеченного в высокой посуде тертого картофеля, сдобная булка, хлеб из гречневой муки, кушанье из вареного мятого картофеля, запеканка из рисовой или другой каши, пенка на кипяченом молоке, петля к крючку которым застегивают одежду, петля на пуговицу, восковая моль, бабушка;
*bаbъkъ:	рукоятка косы, насекомое, божья коровка, перекладина, мелкие стеклянные монисты;
*babyka:	растение, вид явора, заика;
*bаbьсь:	старуха, старая баба, крупный орех, бабник, трус, кукла, растение, баба, дед, старик, головастик, подкаменщик;
*bаbьjь:	принадлежащий бабке (старухе), старушечий, бабий, женский, бабий, бабушкин;
*bаbьnikъ:	род свиной колбасы, бабник, вид шалфея, форма для выпечки теста, бабий угодник, прихвостень, волокита;
*babьskъjь:	бабий, старушечий, знахарский, женский, бабский, бабушкин;
*bacati(sę)/*bocati(sę):	целовать, щелкать пальцем по голове, колоть, покалывать, толкать, бить, пачкаться, грязниться, бодать, бросать, метать, стрелять, злиться, ползти на четвереньках, медленно идти, прорастать, пинать, ударять, бухать, хлопать, бить со стуком, ударяя производить сильный, резкий отрывистый звук, стрелять, колотить, стучать по полу при ходьбе, громко стучать, сбивать, бацать, ударять лбом (о баране);
*baciti:	поцеловать, бросить, выстрелить, ударить, делать что-либо;
*bacnǫti/*bocnǫti:	поцеловать, чмокнуть, щелкнуть, кольнуть, уколоть, приколоть, прикрепить, толкнуть, пихнуть, ударить, выстрелить, упасть с высоты, упасть с грохотом, швырнуть, упасть, свалиться, ударить челом, удариться обо что-либо, ушибиться, упасть с шумом;
*bačęgъ?/*bočęg?:	заливаемая весеннею водою ложбина, лужицы от дождя, небольшие ямы, пруды постоянно наполненные водой, глубокая лужа, колдобина, ямина залитая водою, омут, большая ямина шире и глубже впадающей в нее речки или ручья;
*bаčiti?:	говорить, разговаривать, сказывать, рассказывать, понимать, слышать, шуметь, шумно разговаривать;
*badadlo:	хирургический зонд, острие, колючка;
*badakъ:	большой чертополох, чертополох, волчец;
*badati(sę):	колоть, ощущать острую боль, колоться, бодаться, силиться припомнить, сказать, сделать что-нибудь, ковыряться, медленно работать (обычно о шитье, вышивании), покалывать, бодать, идти потихоньку, прорастать, плохо работать, испытывать, исследовать, колоть (острым орудием), жалить, закалывать ножом (поросенка), идти мелкими шажками, подталкивать, идти кое-как, убеждаться наощупь присматриваясь прислушиваясь, толкать, бодать, размышлять, ударять, колоть рогами (о рогатом скоте), лить (воду), пачкаться, мараться, возиться в грязи, пачкать (о краске), ходить без дела, болтаться, допытываться, доискиваться, углубляться во что-либо, заниматься, стараться, превозмогать трудности, перебиваться, скитаться, шляться;
*badoriti?/ *baduriti?:	обманывать, подталкивать, подзадоривать, подначивать, болтать, болтать небылицы, казаться;
*badъ:	заостренный стержень;
*bаdъlь:	травянистое растение, острый железный наконечник которым погоняют волов, колючка (ежа), овод, рыба, то чем погоняют волов, глазная болезнь, высокое тернистое растение, стебель, ствол;
*badylь:	железная лопата, растение, заступ для рытья земли, перо лука, стебель кукурузы, стебель без листьев, сухой ствол, стебель, трость, былинка, бодливый;
*badylьje:	стебли, былинки, ботва, сухие стебли от соломы;
*bagati:	догадываться, сильно желать, хотеть, захотеть, пожелать;
*bagatьje:	огонь, горящие угли, костер, горящее уголье, пламя;
*bagna/bagn'a:	растение короставник полевой, то же что багун, заросли багульника, дорога, тропа выстланная по раде (болоту) бревешками, бревенчатая мостовая, мостовинник, грязь в поле, топь, болото;
*bagnatъjь:	болотистый;
*bagnĕti:	делаться болотистым, тинистым, топким;
*bagnistъjь:	болотистый, топкий, низкий, мокрый, тинистый, илистый;
*bagnišče:	болотистое место, большое болото, болото;
*bagniti?:	делать болотистым, гноиться (о ране, язве), мостить бревнами дорогу на раде (болоте), сильно топить, топить жарко (печь), сильно идти (о дожде), долго и больно бить;
*bagnitъjь:	болотистый, топкий;
*bagno:	болото, топь, большое болото, тина на дне тихих рек потоков и болот, ил, растение багульник болотный, трясина, багульник, грязь, низкое и топкое место, глубокая грязь, болотистая местность, беспорядок, мусор, сенокос;
*bagnǫti:	жаждать, вожделеть, сильно желать, хотеть;
*bagnъ:	болото при ключе, растение багун, багульник, зоря, багульник болотный, болото, кустарник багульник;
*bagnъka:	вид болотного травянистого растения, пресноводное животное, вид болотной травы, лужа;
*bagnьcь?:	растение крапива;
*bagnьje:	болото;
*bagnьnъjь:	болотный;
*bagotiti?/*bagъtiti?:	стремиться, жаждать, сильно желать, стараться, желать;
*bagǫtьnъjь:	жадный;
*bagra:	краска, цвет, окраска, пурпур, багрянец, мазь которой смазывают сети чтобы они не рвались от сухости, растение, красная краска, вид морской рыбы;
*bag(ъ)rĕnъ(jь):	багряный, тёмнокрасный, пурпурный, багряный, акация;
*bag(ъ)riti:	окрашивать в пурпурный цвет, красить, окрашивать, строить, красить (в красный цвет), багрянить, румянить, красить в пурпурный цвет;
*bagro:	часть колеса, багор, металлический наконечник багра, косяк, часть составного обода колеса, обод колеса;
*bagrovъjь:	багровый, пурпурный;
*bag(ъ)rъ I:	багрец, багряница, порфира, багряный;
*bag(ъ)rъ II:	деревянная гнутая часть колеса, выгнутые кирпичи идущие на постройку печей, верхний подвижный мельничный жернов, багор (длинный деревянный шест на который насажен железный наконечник с острием и крюком), косяк колесного обода;
*bagrьcь:	пурпурная краска, пурпур;
*bagti:	хотеть, желать;
*bagъvinьje:	род водорослей, водоросли, тина;
*bagъvьnikъ:	название растения, растение баговник, небольшой ядовитый кустарник резкий запах которого вызывает головную боль, болиголов, то же что багульник;
*bagy:	тундры, болота, болотистая низменность, топь;
*bахаčь:	хвастун, все пузатое толстое;
*bахаrь:	сказочник, говорун, краснобай, знахарь, любовник;
*baxati:	топать, хвастать, бить, ударять, колотить, бахать, стучать, хлопать, стрелять, толкать;
*bахаtъ(jь):	гордый, надменный, хвастливый, толстый, пузатый;
*baxnǫti:	явиться как снег на голову, ударить, ударить с шумом, бахнуть, упасть, выстрелить (из ружья), толкнуть;
*baxora:	сказка, басня, выдумка, побасенка, ребенок только еще начинающий говорить, набухшая слива, разговорчивый человек, балагур, тот кто хвастается бахвалится, знахарь, знахарка
*baxorica:	колдунья, знахарка, вид колбасы;
*baxoriti:	колдовать, заговаривать (болезнь, горе), хвастать, болтать, говорить, разговаривать, беседовать, сплетничать, наряжаться, говорить попусту, ворожить, гадать;
*bахоrъ:	прямая кишка (свиньи, нафаршированная как колбаса), круглый сосуд с узким горлышком для водки, кровавая колбаса, колдун, живот, часть внутренностей животного, передний желудок у жвачных, брюхо (у человека), самая большая часть желудка у жвачных, внутренности животного, пузо (человека), что-либо выпуклое, полость чего-либо, толстощекий мальчик;
*bахunъ:	хвастун, крикун;
*bахъ?:	гордец, шум, грохот, говорун, краснобай;
*baxъtati:	крякать (об утках), болтать, хвастать, важничать;
*baxъtĕti?:	пугать, бахвалиться, гордиться;
*baxъtъ?:	шум, грохот, топот;
*baja/*bajь:	чары, сглаз, колдовство, заклинание, миф, басня, фантазия, прозвище веселой говорливой женщины рассказчицы;
*bajačь:	знахарь, колдун, тот кто рассказывает басни небылицы;
*bajadlica:	колдунья, знахарка;
*bajadlo:	колдун, то же что баюн, говорун, рассказчик;
*bajadlьcь:	колдун, знахарь;
*bajadlьnica:	плутовка;
*bajadlьlьnikъ:	плут, мошенник;
*bajadlьnъ:	колдовской, волшебный;
*bajanъ?:	обаятель, певец, то же что баюн, говорун, рассказчик;
*bajati I:	шептать заговоры, заклинания (о знахаре, колдуне), рассказывать, лечить (заговорами), словно, как будто, кажется, колдовать, ворожить, заговаривать (болезнь, горе), болтать, предсказывать, гадать, говорить (небылицы, вздор), выдумывать, рассказывать (сказки, басни, небылицы, выдумки), обаять;
*bajati(sę) II:	незаметно гореть, тлеть, мерцать;
*bajidlo:	колдовство, заговор;
*bajidlьja:	знахарка, шептуха;
*bajiti:	зевать, произносить с зевотой, сочинять, фантазировать, вымышлять, грезить, мечтать, тосковать, говорить, разговаривать, рассказывать, манить, приманивать, рассказывать сказки;
*bajunъ:	баюн, говорун, краснобай;
*bajь:	ворожба, колдовство, очарование, чары, миф, фантазия, легенда, сказание, веселый рассказчик, говорун, речь, способность говорить, знахарь, колдун, сказочник, забава, развлечение, веселье;
*bajьda:	болтун, враль, гуляка, беспечный человек, прозвище неуклюжей женщины, краюха, ломоть хлеба, болтать, нести вздор, болтать вздор, говорить чепуху, бездельничать, бить баклуши;
*bajьka:	сказка, басня, выдумка, ворожба, заговоры, неправда, байка, говор, безделица, шутка, пустяки;
*bajьnъ(jь):	очаровательный, упоительный, сказочный, баснословный, легендарный, мифический, устный, таинственный, прекрасный, великолепный, фантастический;
*bakati:	ссорить, натравливать, много болтать о пустяках,(весело) кричать, ругать, говорить, разговаривать, беседовать, пустословить, сказать что-либо тихо, сообщить что-либо не вовремя, обидно выражаться, сильно ударить о землю, буркнуть;
*bакоšь?:	большая корзина куда складывают яйца подаренные на рождество;
*bаkul'а/*bаkъl'а:	первый слой древесины (особенно у дуба) непосредственно под корой около трех пальцев в толщину, заболонь, шишка, нарост, желвак, толстая кривая палка, прыщ, пузырь, выстроганная палочка для веретена, чурка, чурбан, большой камень, островок, колышек (деталь саней), озеро, речной проток, проран в плавне в камышах, глубокая яма в реке пруде, грязный наполненный водою ухаб на дороге, выбоина, ложбина посредине которой лужа, яма, канава, ухаб, большой овраг, залив, губа, лужа, заязь, заязок в проточной воде перед плотиною, от напора льда, рытвина на летней дороге, глухой заливец или ковш, колдобина, ямина которая наливается водой по весне и остается как бы озерком, глубокая зажора по дороге в распутицу, яма наполненная водою, заболоченная мокрая равнина, дубина, палка, нерасторопная женщина, изгиб реки, глубокое тихое место в реке, заводь, яма вырытая водой во время весеннего разлива, дубинка, толстый обрубок дерева, толстяк;
*ba(d)la?:	ворожбит;
*balagovati:	говорить неясно, бормотать, тратить время впустую;
*balaguriti:	балагурить, говорить (весело, забавно, пересыпая речь шутками, остротами), вести пустую беседу, балагур;
*balakati:	плескаться (играя в воде), болтать (что угодно), говорить (небылицы), вносить смуту, смущать, балакать, шутливо разговаривать (о том, о сем, без цели, без плана), калякать;
*balamǫta/*balamǫtъ:	тот кто морочит голову людям, смятение, беспорядок, смута, неприятность, баламут (беспокойный, производящий тревогу, смуту человек), вздорный болтун, сплетник, смутьян, пустой человек, возмутитель, нарушитель душевного покоя, обольститель, знахарь, непостоянный, пустой и болтливый человек;
*balamǫtiti:	вводить в заблуждение, обманывать, лгать, сбивать с толку, сеять смуту, ложные слухи, мутить, баламутить, делать мутной чистую воду, производить несогласие, раздор, темнить, возмущать, смущать, нарушать покой, будоражить, лежать под паром, не возделываться;
*balamǫtьnъjь:	лживый, обманчивый, баламутный, болтающий пустяки, любящий сплетни, сбивающий с толку, мутный, нечистый (о жидкостях), непокойный, тревожащий;
*bаlаmъčь, *bаlаmъčьnъjь:	балмошь, дурь, сумасбродство, безрассудство, бестолочь, обман, балмошный, дикий, несуразный по своим выходкам, эксцентричный, дурачиться, тревожить, будоражить, беспокоить, прихоти;
*baliti/*ba(d)liti?:	шутить, проказничать, болтать, разговаривать, болтать;
*ba(d)lovati(sę):	лечить, заниматься, увлекаться, мешать кому-либо в работе, болтать, нести вздор, обращаться, обходиться, баловать, потворствовать прихотям, капризам, шалить, ласкать, снисходительно обращаться, смеяться, быть опытным в чем, развлекаться, добиваться своего;
*balovina?:	ковыль, тенистое карасевое озеро;
*ba(d)loviti?:	говорить вздор, глупости, парить в печке;
*ba(d)lunъ:	шалун, баловник, баловень, избалованный человек, рассеянный, невнимательный человек, лентяй;
*bаlъkа:	ковыль, маленькое озеро в долине, сухой овраг в степи, балка, впадина на дне реки, камыш, долина, ложбина, длинный и широкий овраг в степи, овраг в лесу, низменная местность, лужа, мокрое место между взгорьями;
*ba(d)ly:	россказни, пустой, забавный разговор, шутки, веселье, остроты, болтовня, разговоры;
*ba(d)lьji:	врачеватель, врач, исцелитель, спаситель (о Христе);
*ba(d)lьstvo:	лекарство, лечение;
*ban'a:	баня (специальное помещение, где моются и парятся), купанье, купальня, ванная, ванна, минеральный (целебный) источник, корыто, купол башни, небосвод, круглая крышка, круглый (пузатый, выпуклый) сосуд, осиное гнездо, шахта, копь, купол, жбан, кувшин, все округлое, тыква, вообще все пузатое, брюхастый сосуд, чаша для воды, большой молочник, все выпуклое, мытье в бане, шар, мыльный пузырь, котел, солеварня, каменоломня;
*bаnъkа/*bаnька:	сосуд которым черпают воду, плоская посудина для жидкости, пузатый сосуд, небольшой купол, маленькая посуда, глиняный пузатый сосуд для питьевой воды, кувшинчик, пузырек, банка (стеклянный или металлический сосуд преимущественно цилиндрической формы), мелкая но широкая деревянная бадья для продажи живой рыбы, коробка, железное кольцо скрепляющее косу и косовище, металлические пустые внутри цилиндры привязанные к верхней тетиве плавной лоховой сети, глиняная посуда с узким горлом для жидкости, пузырь на воде;
*bаnьskъ(jь):	банный, минеральный, водолечебный, шахтный, горнодобывающий;
*bаrа:	речка, поток, стоячая вода, лужа, маленький поток, маленькая речка, маленький источник крытый и огражденный камнем, луг, болото, топь, большое болото, грязь, скоп грязной воды, выемка с водой, возвышенность в общем значении, яр, обрыв;
*baranica:	баранья шапка, овца, матка, овечья шкура, овчина, штаны из овчины, выделанная баранья шкура, баранья полость, полость из овчины, овчина для укутывания ног зимою в дороге;
*baranina/*boranina:	баранина, запах барана, мясо (барана или овцы), баранье мясо;
*baranovъ(jь):	бараний;
*bаrаnъ:	(черно-белый) козел, (шерстный) баран, дурак, железная тяпка, название сорта яблок, приспособление для переноски травы, сережки на иве, самец овцы, тяжелая колотушка, баба, овечка, ягнёнок, овечий самец, стенобитное орудие, таран, толстый брус, тонкий сорт бараньей кожи, нестриженая баранья шкура, шуба из овчины, праздник молотьбы, название кушанья (печенье), гребень морской волны, птица бекас, военная осадная машина, овца, легкомысленный человек;
*bаrаnьсь:	молодой баран, растение плаун, чабрец, богородская трава, крапива, бекас;
*baranьjь:	бараний, овечий, сделанный из шкуры барана, относящийся к барану, приготовленный из баранины;
*barati:	трогать, касаться, искать, спрашивать, работать, просить, требовать, рыться, шарить, щупать, ломать, пронзать, сражаться;
*barina:	lacuna (впадина?), трещина, щель, топь, (сырое) болотистое место;
*barišče:	большая лужа, болотистое место, болото;
*baruga/*barǫga?:	поток, лужа, низкий источник обложенный камнями, (маленький) водоворот, русло по которому вода бежит от плотины на мельницу, омут куда больше всего собирается рыбы;
*baruxati?:	мять, комкать;
*bаrъ:	болото, место непригодное для хозяйственных целей, глубокое место в море где останавливается пароход, мокрое место между холмами;
*barьje:	поле под водой, болото, топь;
*bаrьnъ:	болотный, болотистый;
*barьskъjь:	болотистый;
*basati:	бить, шлепать, ударять, сильно ударить, страдать, мучиться, идти не глядя, есть, напихивать, набивать, украсть, резать (крупными кусками), рубить;
*basiti:	занимать кого-либо разговорами, россказнями, толковать, калякать, болтать, заговаривать, лечиться;
*basnica:	сказочница, сказительница;
*basnikъ:	поэт, знахарь, шептун, колдун;
*basnь:	сказка, выдумка, басня, ложь, заговор, заклинание (против болезни), вымысел, стихотворение, поэма, (небольшой нравоучительный) рассказ, небылица, обаяние, предание;
*basъkъjь:	красивый, нарядный, прекрасный, хороший, говорливый, речистый, бойкий на разговор, ретивый, рьяный, резвый (о коне);
*bata/*bat'a/*batja:	старший брат, отец, кум, друг, приятель, свекор, деверь, пожилой человек, милый, братец, маленький коренастый парень, сестрица, известный немолодой человек, дядя, батя, священник, дед, крестный отец, тесть, почтительное или ласковое обращение к старшему по возрасту, батюшка, батька, духовный отец, почтительное приветствие пожилому человеку;
*batati:	бить, колотить, бить по воде багром или батаухой для того чтобы испугать рыбу и загнать ее в сети, искать (бегая), бегать для розысков, наносить вред;
*batica:	третья часть молотильного цепа, толстый конец цепа, дубинка;
*batikъ:	короткое древко цепа, палка с утолщением на одном конце использующаяся для разных целей, часть цепа ударяющая по снопам, било;
*batina:	палка, удар палкой, дубинка, колотушка, точный удар;
*batiti(sę):	отскакивать, бить назад (например о ружье дающем отдачу), издавать глухой звук от удара, бить, стучать, лгать;
*batjina:	отцовское наследство, отчизна, родовое имущество, наследство, родной край, родные места;
*batjinъ:	отцовский, отеческий, братец;
*batogъ:	батог, палка, сушеная рыба, плетка, дорожная заплечная котомка, здоровенная дубина, битье палкой, бич, плеть, батог, трость, простая из лесного дерева палка, бильная (бьющая, короткая) часть цепа, посох, хворостина, било, долгий (большой) кнут на длинном кнутовище, вообще рычаг, толстая длинная палка, часть ткацкого станка, палка у молотила, планка, растение, усы (у огурцов, дынь), кол;
*batoriti:	шуршать, шуметь, лепетать (о ребенке, начинающем говорить), разговаривать, беседовать, будить;
*batъ:	стрела у весов, дубина, колотушка, палка, определенная мера земли, жезл, (деревянный) молоток, кнут, полый железный конус на длинном шесте которым ударяют по воде во время рыбной ловли чтобы испугать рыбу; прут, долбленое сосновое или осиновое корыто с прибитыми по бокам для устойчивости бревнами, лодка (обычно небольших размеров) выдолбленная из толстого дерева (целого ствола), однодеревка, два (иногда три) соединенных вместе долбленых корыта или колоды использующиеся вместо лодки, парома, батог;
*bava:	довольство, забава, игрушки, достаток, обилие, разговор, беседа (долгая), потеха;
*bavežь:	промедление, задержка;
*baviti(sę):	медлить, задерживать (кого-нибудь), забавлять, мешать кому-нибудь, задерживаться (дольше на одном месте), терять время, оставаться, оттягивать, тянуть, опаздывать, заниматься, развлекать, интересовать, отнимать время, коротать время, развлекаться, мешать в работе, забавляться, пребывать, занимать, мешкать, делать что-нибудь не скоро, говорить, с трудом обходиться, кое-как перебиваться, проводить время, увлекаться, забавлять, удерживать, задерживать, замедлять, тратить, пройти, миновать, играть, тешить;
*bavǫtъka:	прибаутка, побасенка, присказка;
*bavьnъ(jь):	медленный, занимательный;
*bazaniti?:	говорить напыщенно, свысока, иногда употребляется в значении лести, сильно кричать, кричать, плакать (с криком), стрекотать, перебивать чужую речь, хвастать, реветь, горланить, кричать, громко петь, буянить, шуметь, стучать, громко лаять, мычать;
*baziti:	громко кричать, плакать, ругаться;
*bazliti:	реветь, кричать, врать;
*bazlo:	крикун, горло, широкое горло, глотка, врун, обманщик, злой человек, бранно о стариках;
*bazovъjь:	бузинный;
*bazuriti:	жить обманом, плутовать;
*bazъ:	бузина, сирень, собачья бузина;
*bažati:	жаждать, (очень) хотеть чего-нибудь, (сильно, пламенно) желать, иметь склонность, (искренно, сердечно) любить, ласкать, усиленно просить, ублажать;
*bažina:	очень сырая местность, болотистая местность, растение;
*bažiti:	сильно желать, много и жадно есть, очень хотеть, стремиться, по поверью с помощью колдовства насылать несчастья на других, ласкать, лелеять, жаждать;
*bažǫtъka:	желанный, милая, милый, любимец, голубчик (о ребенке);
*bеbrĕnъ:	бобровый;
*bebrina:	мясо бобра;
*bebrovьna:	жилище бобра;
*bеbrъ:	бобр, бобровый мех;
*bеbrъkъ:	маленький бобр, бобренок;
*bečati:	мычать, кричать, блеять (об овцах, овце, козе), хныкать, плакать, мекать, блеять;
*bedra:	бедро, ляжка, пах, поножи, верхняя часть лядвеи, верхняя половина всей ноги, часть от таза до колена, лядвея;
*bedratъ(jь):	широкобедрый, с большими ляжками, с развитыми бедрами;
*bedrenica/*bedrьnica:	бедренная кость, болезнь крупного рогатого скота, свиней, бок чего-либо (кровати, ткацкого станка), растение бедренец ,кривая деревянная часть седла сзади, прострел;
*bedrenikъ/*bedrьnikъ:	растение бедренец, болезнь, гусиная лапка;
*bedrenьcь/*bedrьnьcь:	растение бедренец (лекарственное степное растение);
*bedrica:	сбитый хлопок раскатанный тонкой и длинной прядью для прядения, бедро, окорок, синяк, кровоподтек от удара на теле, растение бедренец, сорт яблок;
*bedrika:	сорт (сладких и твердых) яблок, яблоко средней величины;
*bedro:	бедро, ляжка, поясница, чресла, бедренная кость, ребро, часть ноги человека или животного от таза до колена, верхняя часть ноги;
*bedrunъka/*bedrunica/*bedrenъka/*bedronъka:	божья коровка, личинка майского жука;
*bedrьce:	ляжочка, бедро, ляжка, голень, берце, берцо, кусок холста служащий для обертывания голеней ног;
*bеdrьnъ(jь) I/*bedrenъjь:	бедренный;
*bedrьnъ II?:	богатый, обильный;
*beka?:	растения осока, чистец, растение с мелкими мясистыми листиками и звездчатыми желтыми цветочками стелющееся по скалам и каменным стенам, вид ивы, растение бековина;
*bekati:	блеять (об овцах), болтать, невнятно бормотать, рявкать, мямлить, кричать (по-козьи, по-овечьи), реветь (о детях);
*beknǫti:	заблеять, проблеять, рявкнуть;
*bekotъ:	блеянье (о мелкой скотине, овец), мычанье (телят), плач;
*belbeniti/*belbeliti:	без умолку молоть, беспрестанно говорить пустяки, не умолкая болтать, много говорить о пустяках, болтать, баять;
*bеlbеnь?/*bеlbеlь:	возвышенное и открытое место, глубокое место в воде, открытая или опустошенная местность без построек и растительности, очень холодный ветер, незаросший, голый бугор, пустошь, глубина;
*belbetati:	болтать, говорить невнятно, невнятно бормотать, лепетать, мямлить, болтать пустяки;
*bel'ati?/*bĕl'ati?:	прихрамывать, ковылять, хромать;
*belnika:	белена, растение белена черная;
*belnovati:	отравиться беленой, предаваться мечтам, грезить, мечтать, болтать;
*bеlnъ/*bеlеnа:	греза, мечта (несбыточная), мечты, белена (ядовитое растение семейства пасленовых), дурак, болван, говорить во сне, бредить, болтать, порочное вожделение, горечь;
*bеlnь:	белена;
*bеrаčь:	тот кто берет, собиратель, сборщик урожая (винограда, кукурузы), сборщик;
*berčina:	вид рябины;
*berdja:	беременная (о животных, обычно о домашних животных, о самке четвероногого), стельная (о корове), жеребая (кобыла);
*berĕja:	женщина собирающая ягоды для домашнего употребления или для продажи;
*bergatъ:	гористый, имеющий берега;
*bergovitъjь:	холмистый, утесистый, обрывистый, стремнистый, гористый, возвышенный, имеющий берега;
*bergovъ(jь):	береговой, относящийся к берегу;
*bergt'i:	беречь, хранить, соблюдать, охранять, сохранять, предохранять, угощать, ухаживать;
*bergul'a/*bergulica:	вид ласточки, стриж, береговая ласточка, трясогузка;
*bergъ:	(высокий отвесный) берег (реки или моря над водою), земное возвышение, обрыв, скат, стремнина, утес, холм, (невысокая) гора, межа, край (земли у водной поверхности), склон (горы, оврага, долины), пристань, откос, бугор, вал, насыпь, куча, громада, около, кайма, возвышенность, пригорок, пропасть, неурожайная земля, взгорье, кромка, продольный край ткани;
*bergyni:	ряженая девушка пугающая ради шутки подруг;
*berica:	собирательница, сборщица;
*beridlo:	кошолка или корзинка с закрывающимся верхом для сбора крупных фруктов, зеленый корм собранный для скота;
*bеriхъ:	собиратель, сборщик;
*berka:	растение (разновидности рябины), боярышник кленолистный;
*berkоvьсь:	вид рябины, тутовое дерево;
*bеrkъ:	вид рябины, лесное дерево Pirus, берека, клен, явор, боярышник кленолистный;
*berkyni:	вид рябины, рябина, лесное дерево и его плод, ягода этого растения, красные ягоды лесного дерева определенного вида, само дерево, берека;
*berma:	деревянный сосуд для воды;
*bermenatъ(jь):	беременный, тяжелый, тяжкий, отягощенный, тяжело нагруженный;
*bermenitъ(jь):	беременная, тяжелый (например о колосе), беременный, отягощенный, обремененный;
*berme(no)noša:	носильщик, переносчик тяжестей;
*bermenьje:	тяжесть, груз, ноша, скарб;
*bermenьnъ(jь):	обремененный, беременная, чреватый, отягощенный, тяжелый, гружоный, носящая в чреве младенца, вынашивающая в себе зародившегося младенца (о женщине);
*bermenьniса:	боченок, приспособленный для переноски и перевозки;
*bermę, род. п. -mene:	груз, бремя, забота, (тяжелая) ноша, тюк, (большая) охапка (сена, дров), вязанка (дров), тяжесть, беременная женщина, мера веса, связка, плод во чреве, узел, котомка, ярмо, сено сбитое граблями для подачи на воз или связанное в вязанку, обременение, наполненный чем-либо мешок перевязанный посередине для удобного ношения, неполный мешок зерна, обязанность доставки подвод, подводы;
*bermišče:	тяжесть;
*bermo:	ноша в обхват руками;
*bersta:	верхний (светлый) слой березовой коры (идущий на выгонку дегтя, выделку лаптей, корзинок и т.п.), кора вяза, береста, березовая кора;
*berstĕnъ(jь):	вязовый, берестовый, берестяной;
*berstika:	вид вяза, ива, название гриба;
*berstikъ:	вязовая роща;
*berstina:	вязовая роща, береста;
*bersto:	березовая кора, береста, письмо, бумага;
*berstovъ(jь):	вязовый, берестовый;
*berstъ:	берест, вяз , вид вяза, бук, дерево, береста, верхняя кора березы годная для гонки дегтя, берестяной поплавок в сетевых рыболовных снастях;
*berstь:	дерево вяз, народное название береста-карагача;
*berstьje:	вязы, вязовый лес;
*bеrь:	сбор;
*bеrьbа:	сбор (урожая, винограда), уборка, время уборки (плодов), время сбора урожая;
*bеrьса:	тот кто берет;
*bеrьсь:	собиратель, сборщик (налогов);
*berьka/*berika:	березовый и кленовый сок, березовый сок собираемый весной и идущий на приготовление кваса;
*berьnа:	c6op (средств), собирание, название меры, сборы в пользу короля, королевская подать;
*berьnъjь:	принятый, имеющий хождение (о деньгах), жадный, заманчивый, емкий, пассивный;
*berza:	береза, лиственное дерево из группы сережчатых большею частью с белой корой и сердцевидными листьями;
*berzavъjь?:	корова у которой спина и живот белые а остальное красное или черное, белопестрый (о волах, о корове), пеструха (о корове);
*berzdьna:	борозда, проход в винограднике, след;
*berzica:	береза, растение метлица, названия пестрых животных, березка, березовый прут, березовый сок;
*berzika:	береза;
*berzikъ:	березовый лес;
*berzina:	береза, древесина березы, березовый лес, группа берез, березовая роща, березовые заросли, в березняке, срезанные березовые ветви, (срезанные) ветки березы, березовая палка, березовый прут, березовое дерево, березовая ветка, розга, березняк;
*berzinъ(jь):	березовый;
*berzovica:	березовая палка, дубинка, вид ядовитого гриба, березовый сока, нацеживаемый весною березовый сок который перебродив образует сладковатый напиток;
*berzovikъ:	березовый лес, гриб березовик, птица вальдшнеп (водящийся в березовых лесах), березовая роща, березовый сок, гриб опенок, майский жук;
*berzovina:	древесина березы, березовая древесина, березовый лес, березовая роща;
*berzovъ(jь):	березовый;
*berzovъcь:	ствол березы, растение, березовый прут;
*berzovьje:	березы, березовая поросль, березовые ветки, березовые дрова;
*berzozolъ:	месяц апрель, месяц март;
*berzujь:	название пустоши;
*berzъ:	береза;
*berzъka:	березка, березовая кора, береза, молодая береза, вид береза малорослая;
*berzьje:	березы, березовый лес, березовая поросль, ветки березы, молодая поросль, березовая роща;
*berzьjь:	березовый, пестрая белая с красным или черным (о корове);
*berzьnikъ:	месяц март, чистый березовый лес, роща, березовый хворост, гриб;
*berzьnо:	ряд местных названий, поток близ Новгорода, топоним;
*berzьnъ/*berzьnь:	месяц апрель, месяц март, название домашних животных белопестрой масти, течка (у кошек), (детские) шалости;
*beržan(in)ъ:	прибрежный житель, жители берега, жители побережья;
*beržina:	холмистое место, крутизна, берег, холм, насыпь, побережье, склон, обрыв, возвышенность, горное сено, отмель идущая от берега в море, прибрежный луг, пожня, трава растущая на морском берегу, редкий лес вдоль берега реки, теплая вода, парное молоко, прибрежье, береговая трава, береговое сено;
*beržistъjь:	крутоберегий, бережистый, c высокими крутыми берегами, пролегающий в углублении как бы между двумя берегами;
*beržьсь:	холм, берег, бережок;
*beržьje:	берег, побережье;
*beržьkъ:	холмик, холм, склон, бережок, край рюмки, берег;
*beržьnъ(jь) I:	береговой, прибрежный, гористый, расположенный на берегу;
*beržьnъjь II:	бережный, осторожный, осмотрительный, бережливый, нерасточительный, тщательно охраняемый, оберегаемый, боязливый;
*besĕda:	(отдельное) слово, речь, (дружеский) разговор (в собрании, с кем-нибудь, преимущественно деловой или задушевный), беседа, язык, развлечение, рассказ, приятное общение с друзьями, пир, садовая беседка, общественное развлечение, общество (людей, гостей), компания, седалище, место сиденья, слова, собрание, скамейка, деревенская вечеринка, посиделка, вечернее собрание молодежи в доме с работой или только для увеселения, пирушка, договор между родителями жениха и невесты о браке, сговор, свадьба, все участники свадьбы, группа пожилых крестьян собравшихся посидеть поговорить на завалинке перед избой или на траве, сидение в гостях без приглашения, толпа, прием, сиденья для ямщика в телеге, место для сидения, постройка в виде галереи со столом и скамейками, общественная изба для крестьянской работы, компанейское веселье с угощением;
*besĕditi:	обсуждать, (авторитетно) разговаривать (с кем-нибудь), говорить (речь), держать речь;
*besĕdovati:	разговаривать, говорить (с кем, к кому), беседовать, вести непринужденный разговор, читать нравоучения, держать речь, (совместно) развлекаться, беседовать, пировать, вкушать удовольствие, жировать (о диких животных), вести с кем-либо деловой или задушевный разговор, принимать участие в посиделках, беседе, сидеть, быть в гостях, проводить время без работы, произносить;
*besĕdunъ:	болтун;
*besĕdъ/*besĕdь:	беседа;
*besĕdъka:	беседка (садовая), общественное развлечение, беседа, крыльцо, веранда, разговор, доска на которой сидят у ворот (в сенях, в лодке и т. п.), козлы (для ямщика), сиденье кучера на телеге, скамья, сидение в лодке, лавка для гребцов в большой днепровской лодке называемой дуб;
*besĕdъlivъ:	разговорчивый, говорливый, болтливый, бранчливый, вздорный, словоохотливый;
*bеz(ъ):	без, через, среди, между, кроме, за исключением, за неимением, кроме, не считая, помимо;
*bezapьnъjь:	неожиданный;
*bеzbirъ:	Bezbir (имя);
*bezbokъjь:	не имеющий боков, выпуклостей, безбокий, у кого или у чего бока впалые или нет одного бока, однобокий, кривобокий, не имеющий бока;
*bezbordъ(jь):	безбородый, не имеющий бороды;
*bezbordьnъ(jь):	безбородый, голобородый;
*bezbr'uxъjь:	не имеющий живота, безбрюхий, тощий, у кого живот мал (плоский или впалый);
*bezbrъvъjь:	безбровый, у кого нет бровей или они очень жидки;
*bezčelьnъjь:	бесстыжий, наглый, безлобый;
*bezčędьnъ(jь)/*bezčędьna(ja):	бездетный, бесплодный, бездетная;
*bezčęstьnъjь:	несчастный, кому нет части (доли, удела);
*bezčьstьnъ(jь):	бесчестный, нечестный, обесчещенный, постыдный, позорный, нарушающий требования чести, недобросовестный;
*bezdarъ:	В(i)ezdar (имя);
*bezdĕdъ:	Bezdĕd (имя);
*bezdĕdjь:	Bezdĕz (название);
*bezdĕtъ:	бездетный;
*bezdĕtьnъ(jь):	бездетный, не имеющий детей;
*bezdobь:	напрасно, безвременно, бесполезный, напрасный;
*bezdolьje:	невзгода, беда, горе, несчастье, продолжительное бедствие, безвременье, плохая судьба, бездолье;
*bezdolьnъjь:	несчастливый, бездольный, бедный, бедовик, несчастливец, человек которому не выпало доли (части, счастья), несчастный, обездоленный, горемычный, бесталанный;
*bezdomovъjь:	безродный, бездомный, плохой хозяин не имеющий своего хозяйства;
*bezdomovьnъ(jь):	бездомный, безродный, бесхозяйственный;
*bezdomъ(jь):	несчастный, злополучный дом, дом без главы семейства, бездомный;
*bezdomьnъ(jь):	бездомный, безродный, неоседлый, бесприютный, бедный, не имеющий жилища (своей семьи, пристанища), одинокий;
*bezdoržica:	распутица, бездорожье, место где нет дороги;
*bezdoržь:	бездорожье, распутица;
*bezdoržьje:	бездорожье, плохая едва проезжая дорога (от распутицы, грязи), время распутицы (дождей, грязи, по весне и по осени), распутица, отсутствие дороги;
*bezdrъvъ:	Biezdrew (имя);
*bezduxъ(jь):	бездушный, бездыханный, неумный, запыхавшийся, мертвый, бессмысленный, не имеющий запаха, малодушный;
*bezdušьnъ(jь):	без души, безжизненный, мертвый, бездушный, бессердечный, бездыханный, неодушевленный, умерший или убитый, бесчувственный к страданиям ближних, дающий мало тепла (о дровах, печах), не издающий запаха, малосильный, слабый, глупый, отличающийся малой физической силой, слабый (о человеке или животном), малопитательный, не сытный;
*bezdъbna:	(глубокая бездонная) пропасть, бездна, глубина (очень большая, кажущаяся неизмеримой, не имеющей дна), запущенное поле, дурное неудобное место, непроходимые места, дикие незаселенные места, глубокая яма, лужа вообще (хоть и неглубокая), топкое болото;
*bezdъbnica:	бездонная яма, бездна, (непроходимое) болото (покрытое болотной растительностью), яма (для картофеля, репы), жалкая лачуга, темница, колодец, о котором рассказывали что он не имеет дна, пропасть, растение семейства зонтичных;
*bezdъbno:	пропасть, бездна;
*bezdъbnъ:	бездна, очень глубокое место в воде, расселина, дыра, яма, стык между досками в полу, пропасть, глубина;
*bezdъbnъ(jь):	бездонный, очень глубокий;
*bezdъbnь:	бездна, пропасть, стык, глубина, пучина;
*bezdъbnьje:	бездна, непроходимое болото, пропасть;
*bezdъbnьnъ(jь):	бездонный, очень глубокий, у чего нет дна, весьма глубокий, ничем не наполнимый, не имеющий дна (о посуде);
*bezdъždžь:	продолжительное отсутствие дождя, засуха, сорная трава при плохих всходах (хлебов) от засухи, трещины в земле от засухи;
*bezdъždžьje:	бездождие, засуха, (продолжительное) отсутствие дождя, сушь, сорная трава при плохих всходах от засухи, трещины в земле от засухи, бездождье, бездождица;
*bezdъždžьnъ(jь):	бездождный, недождливый, сухой, засушливый, не содержащий в себе, не приносящий дождя, лишенный дождей;
*bezgluzdica:	бессмыслица, нелепость, несуразица, чепуха, галиматья;
*bezgluzdъjь:	безглуздый, бессмысленный, бестолковый, безмозглый, несуразный, глупый, нелепый;
*bezgluzdьje:	бестолковость, глупость, непонятливость, бессмыслица, нелепость, несуразность, несуразица, несообразность, безрассудство;
*bezgoda:	безгода, беда, несчастье, невзгодье, неудача, бесталанность в жизни, бедствие, невзгода, безгоды, безвременно;
*bezgodьje:	неугодное время, неблагоприятное время или положение, безгодье, неурожай, непогода, ненастье;
*bezgodьnъ(jь):	несвоевременный, неугодный, безвременный, безгодный, преждевременный, проживший очень много лет, очень старый, малолетний;
*bezgolsъ(jь):	молчание, безмолвие, безгласный, тихий, немой, безголосый, у кого нет голоса (вовсе, певчего) или голос слабый, невнятный;
*bezgolsьnъ(j):	не подающий голоса, немой, тихий, безгласный, безмолвный, беззвучный, безголосый;
*bezgolvъ(jь):	безголовый, растерянный, смущенный, без головы, безрассудный, помешанный, безмозглый, беспомощный, лишенный головы, обезглавленный, лишенный здравого смысла, глупый, тупой, не имеющий головы, безумный, бессмысленный;
*bezgolvьnь(jь):	безголовый, без головы, без главы (семья, дом), безголовное (дело), уголовный;
*bezgǫbъjь:	безустый, безмолвный, безгубый, не имеющий губ;
*bezgǫzъjь:	безгузый, бесхвостый (о птицах);
*bezgrivъ(jь):	без гривы, безгривый, не имеющий вовсе гривы или весьма малую;
*bezgrivьnъ:	безгривый, без гривы;
*bezxvostъjь:	бесхвостый, не имеющий хвоста, о животном, куцый;
*bezimenьnъ(jь):	безымянный, безыменный, безымённый, безымянный, кому или чему не дано имени (названия, клички);
*bezkorenьnъjь:	не имеющий корней (корня);
*bezkorъjь:	не имеющий (лишенный) коры, бескорый;
*bezkostĕnъ:	бескостный;
*bezkostъjь:	бескостный, в ком или в чем нет костей, не имеющий костей;
*bezkostьnъjь:	бескостный, в ком или в чем нет костей;
*bezkridlъ(jь):	бескрылый, не имеющий крыльев;
*bezkridlьnъ(jь):	бескрылый, бескрыльный, у кого или у чего нет крыльев;
*bеzkrъvъjь:	бескровный, безжизненный, мертвый;
*bеzkrъvьnъ(jь):	бескровный, обескровленный, малокровный, бледный, в чем или в ком нет крови или ее мало, совершаемый без пролития крови, у кого нет близкого родства, родных, одинокий, безродный;
*bezlĕsъjь:	безлесный, безлесый, оголенный, не поросший лесом, голый, голопочвенный;
*bezlĕsьje:	безлесье, отсутствие лесов, безлесное место;
*bezlĕsьnъjь:	безлесный, оголенный, не поросший лесом, голый, голопочвенный;
*bezlĕtьje:	безлетье, несчастье, невзгода;
*bezlĕtьnъjь:	безвременный, вечный, мгновенный;
*bezlędvъjь:	безлядвый, ленивый, непроворный;
*bezlistъ(jь):	безлистный, не имеющий или лишенный листьев, безлиственный, безлистый;
*bezlistьnъ(jь):	безлистный, (о деревьях) обнаженный от листьев;
*bezl'udica:	безлюдица, отсутствие (недостаток) людей;
*bezl'udьje:	безлюдная местность, незаселенное (уединенное, отдаленное, глухое) место, безлюдье, отсутствие (недостаток) людей, малонаселенность, пустота, люди негодные (обычно по возрасту) для работы, плохой (глупый, непонятливый бестолковый, безалаберный) человек;
*bezl'udьnъ(jь):	безлюдный, обезлюдевший, опустевший, ненаселенный, малолюдный, малонаселенный, необитаемый;
*bezmirь:	Bezmir (название деревни);
*bezmozgъjь:	безмозглый, глупый, тупой, безмозгий, не имеющий мозга или мозгов, безмозгатый, несообразительный;
*bezmъlvьjе:	безмолвность, безропотность, бесшумность, тишина, безмолвие;
*bezmъlvьnъ(jь):	безмолвный, спокойный, немой, покойный, тихий;
*bezmьzdьnъjь:	бескорыстный, безвозмездный, бесплатный;
*beznogъ(jь):	безногий, лишившийся (не имеющий) ног или ноги;
*beznosъ(jь):	безносый, у кого или у чего нет носа или носка, курносый, прозвище человека с маленьким носом, не имеющий носа;
*beznožьnъ:	безногий;
*bezobpašь:	В(i)ezopasz (имя);
*bezočitъ:	бесстыдный, бесстыжий;
*bezočivъ(jь):	бесстыдный, беззастенчивый, дерзкий, наглый, безочивый, безглазый;
*bezočь:	слепо;
*bezočьjь:	безглазый, слепой, незрячий;
*bezočьnъ(jь):	бесстыдный, бессовестный, наглый, нахальный, безобразный, дерзкий, распущенный, безглазый, слепой, незрячий, безочный, безокий, темный;
*bezokъ(jь):	безглазый, слепой, нахальный, одноглазый, кривой;
*bezotьnъjь:	безотный, сирота у которого нет отца, не имеющий отца, сиротский, ребенок лишившийся отца;
*bezǫsъjь:	безусый, у кого нет усов, не имеющий усов;
*bezpalъjь:	беспалый, у кого нет одного или более пальцев;
*bezpamętьnъ(jь):	беспамятный, безумный, неразумный, лишенный памяти, безрассудный, у кого слабая память, забывчивый, непомнящий, имеющий слабую память, забывчивый, находящийся в беспамятстве;
*bezpečьnъjь:	беззаботный, безопасный, бесстрашный, уверенный, надежный, обеспеченный, гарантированный, беспечный;
*bezpers(t)mene/*bez pers(t)mene:	беспрестанно;
*bezperstani/*bez perstani:	беспрестанно, непрерывно;
*bezperъjь:	бесперый, лишенный перьев, не имеющий перьев, неоперившийся, беспёрый, на ком или на чем нет перьев, рыба без перьев, без плавников;
*bezplemenьnъjь:	бессемейный, безродный, бездетный, одинокий, бесплеменный, у кого ни рода ни племени, без племени, беспотомственный;
*bezplodъjь:	бесплодный;
*bezplodьnъ(jь):	бесплодный, яловый, бездетный, не знающий плода, неплодный, неплодородный;
*bezpǫta:	бездорожье;
*bezpǫtica:	беспутица, бездорожье, непроходимая местность, бездорожица, распутица или иная порча дороги;
*bezpǫtъ:	бездорожье;
*bezpǫtьje:	бездорожье, непроходимая местность, беспутье, бездорожица, распутица или иная порча дороги, беспутица;
*bezpǫtьnъ(jь):	бездорожный, непроезжий, непроходимый, беспутный, в ком или в чем нет пути (толку, проку, пользы), теплая (про зиму, когда зимний путь не устаналивается);
*bezprĕmъ(jь):	чрезмерный, несносный, строптивый;
*bezprokъjь:	беспрокий, в ком в чем нет прока, негодный, беспутный, неспособный, неумелый, беспомощный в работе, неуклюжий, неловкий, бессильный, немощный;
*bezpьrstъjь:	беспалый, без пальцев, беспёрстый;
*bezpьrstьnъjь:	беспалый;
*bezrędъ:	B(i)ezrzad (имя);
*bezrodьnъ(jь):	незнатный, неблагородный, бесплодный, неплодородный, безродный, осиротевший, не имеющий родителей, бездетный, одинокий, у кого нет родителей (близкого родства), сирота, сирый, бесплеменный, незаконнорожденный;
*bezrogъ(jь):	безрогий, комолый, не имеющий рогов;
*bezrožьnъ:	безрогий;
*bezrǫčьnъjь:	безрукий;
*bezrǫkъ(jь):	безрукий, однорукий, лишившийся (лишенный, не имеющий) руки или рук;
*bezrudjь:	безружъ, бледность лица;
*bezrydlъ:	безрил, прозвище человека с тонкими губами;
*bezsilьnъ(jь):	бессильный, слабый, не могущий одолеть кого или что;
*bezskridlъjь:	бескрылый;
*bezsnĕžьnъ(jь):	бесснежный, голая (зима, местность), лишенная снега, малоснежная, скудная снегом;
*bezsormьnъ(jь):	бесстыдный, наглый, распущенный, нахальный, бессрамная, бесстужая (бесстыжая), бесстудная (бесстыдная);
*bezsǫkъjь:	без сучьев;
*bezstraxъjь:	бесстрашный;
*bezstrašьnъ(jь):	бесстрашный, бесстрашно, не знающий страха (боязни), бестрепетный, неробкий, удалой, неустрашимый;
*bezstryjь:	Biezstryi, Biestryi (имя);
*bezstudjь(jь):	бесстыдный, дерзкий, усердный в работе, прилежный, нахальный, стыд, срам, позор, бесчестье;
*bezstudъ:	Bestud (имя);
*bezstudьnъjь:	бесстыдный;
*bezstydьnъ(jь):	бесстыдный, постыдный, нахальный, нестыдливый, не знающий стыда, бессовестный, наглый, позорный, бесчестный, бесстыжий;
*bezsъpnъ:	бессонница;
*bezsъpnъ(jь):	бессонный, бодрствующий;
*bezsъpnь:	бессонница;
*bezsъpnьje:	бессонье, бессонница;
*bezsъpn(ьn)ica:	бессонница, состояние когда не спится, невольное бдение;
*bezsъpnьnъ(jь):	бессонный, неусыпный, лишенный сна, проведенный без сна;
*beztǫžьnъ(jь):	переносимый без жалоб (без труда), беззаботный, беспечный, не испытывающий тоски (стремления);
*bezudьnъ(jь):	увечный, лишенный члена, безудный, бесчленный;
*bezuxъ(jь):	безухий, одноухий, прядильное или ткацкое приспособление, не имеющий уха (ушей, ушка);
*bezujь:	Biezuj, Biezwuj (имя);
*bezukъ:	безук, хороший плотник;
*bezumjь:	неразумный, безумный;
*bezumъ:	безумие, безумный, беспокойный (шаловливый) ребенок, непоседа;
*bezumьje:	безумие, безумье, недостаток или слабость ума;
*bezumьnъ(jь):	безумный, глупый, неразумный, нелепый, малоумный, помешанный, шальной, безрассудный;
*bezušьjь:	безухий, без одного уха;
*bezvertmenьje:	нехорошее положение, недобрый час;
*bezvĕčьje:	увечье, болезненное состояние от недугов или от каких насилий, делающее человека неспособным к работе;
*bezvĕčьnъjь:	увечный, калека, расслабленный, вековечный, бесконечный;
*bezvĕkъ(jь):	вечный, бесконечный по времени;
*bezvĕstъ:	безумный, помешанный;
*bezvĕstь:	неизвестность, неведомые места;
*bezvĕstьnъ(jь):	тайный, неизвестный, безвестный, ничего не говорящий, бессмысленный, неведомый, без вести пропавший, неизвестно где находящийся, никому не известный или незнакомый;
*bezvĕtrъjь:	безветренный;
*bezvinьnъjь:	невинный, невиновный, безвинный, неповинный, непричастный вине, не виноватый в чем;
*bezvodica:	недостаток воды (влаги), безводица;
*bezvodъjь:	безводный;
*bezvodьje:	отсутствие (нехватка, недостаток) воды, безводье, засуха, безводное место, сушь;
*bezvodьnъ(jь):	безводный, засушливый, бедный водой (влагой), лишенный воды;
*bezvolsъ(jь):	безволосый, лысый, плешивый, голый, гладкий;
*bezvolsьnъ:	безволосый;
*bezzorьnъjь:	постыдный, унизительный;
*bezzǫbъ(jь):	беззубый, у кого или у чего нет зубов;
*bezzǫbьnъ(jь):	беззубый;
*bĕda:	страдание, бедствие, надобность, необходимость, принуждение, беда, несчастье, нужда, бедность, незаслуженное обвинение, напраслина, клевета, нищета, нечистый, дьявол, недостаток, скудость, сундук с приданым, горе, печаль, скорбь, опасность, несчастный случай, неприятность, горемыка, несчастный человек, провинность, кошелек, мошна, бес, бесовская сила, нечто страшное;
*bĕditi(sę):	принуждать, уговаривать, убеждать, клеветать, взводить напраслину на кого-либо, ябедничать, винить, думать, несправедливо нападать, доводить до нищеты, мучиться, бедствовать, жить в нужде, бороться, напрягаться, биться, возиться, губить, портить, приводить в досаду, проказничать, шалостью причинять вред, доставлять неприятности или ущерб, воровать, приносить беду кому-либо;
*bĕdьnъ(jь):	бедный, убогий, трудный, опасный, несчастный, жалкий, недобрый, злополучный, скудный, низкий, низменный, болезненный, увечный, неимущий, нищий, в беде (в нужде) находящийся, горестный, тягостный, лишенный достаточных (необходимых) средств для существования, содержащий в себе мало чего-нибудь, имеющий недостаток чего-либо, стоящий недорого, простой, дурной, недобрый, горемычный;
*bĕgačь:	бегун, молодой олень, беглец, гонец, рабочий в шахте (с тележкой, возит на тачке уголь);
*bĕgati:	бегать (туда-сюда), убегать, бежать, избегать, уклоняться, гонять, сбивать с толку, запугивать, гоняться, испытывать половое влечение (о корове), страдать расстройством кишечника, быстро двигаться (преимущественно в разных направлениях, о предметах неодушевленных), (усиленно, ускоренно) ходить, ездить, плыть (под парусом), быстро идти;
*bĕgota:	понос, название кошки в сказке;
*bĕgǫtъjь:	быстрый, бегущий, подвижный, сыпучий (о песке);
*bĕgt'i:	бежать, быстро идти, спешить, стремиться, избегать, течь;
*bĕgunъ:	беглец, бегун, бродяга, парень, скакун, изгнанник, повеса, верхний жернов, вращающийся брус, ось (на которой ходит дверь, ворота), шейный позвонок, подросток, юноша, большая часовая стрелка, приспособление для обучения детей бегу, колышки (колышек, в пороге на которых вращается дверь в хлев), колесо с приводом, гонец, поросенок (который уже бегает, подвижная часть машины (приспособления), ковровая дорожка, трусливый, прыткий на ногах, скороход, мастер бегать, перебежчик, быстро бегающий, извилистый узор, зигзаг, род колбасы, лен, верея, столб (на который прежде навешивались ворота, калитка, дверь);
*bĕgъ:	бег, бегство, побег, ход, нога зайца (серны, собаки, пернатых), быстрое движение, вращение, течение реки, беготня, оборот;
*bĕlasъ(jь):	светлый, голубой, белесый, растение, беловатый, белеющий, лошадь светлой масти;
*bĕlavъ(jь):	беловатый, недостаточно белый, животное (самец, корова) белой масти (или с белой меткой), обезжиренный сыр из сыворотки, мелкое место в море (где песок просвечивает сквозь воду), белый цвет, заболонь (в дереве), водка-первач, белила, отбеливание, побелка, светлобелая струя в воде, голубой, небольшой пруд, белавый, светлый, весьма бледный, избела цветной, белокурый, блондин, белесый, вид сливы;
*bĕlesъjь:	белесый, белёсый, тускло-белый, светловатый (о цвете, освещении), беловатый, белка, лошадь белой масти, изделие из теста, печёная оладья (помазанная повидлом и посыпанная маком или творогом), булочка;
*bĕlĕti(sę):	белеть, выцветать, седеть, бледнеть, отмечать, помечать, белеться, сиять белым цветом, выделяться белизной, становиться белым, казаться белым, рассветать;
*bĕlica:	белая овца, (речная, белая, мелкая, пресноводная) рыба (уклейка, елец), сорт пшеницы, черешня (слива) светлого (белого) цвета (плод и дерево), белая крупная ягода, растение белой окраски, животное белой масти, пшеница, яблоня, белая овца без пятен, вид земли, вид картофеля, вид шелковицы, сорт яблок, вид вышивки на белой основе, желтоватая слива, белая коза, вид куницы, вид ужа, мужская конопля, сорт груш, яйцо, свинцовые белила, белая верба, женщина со светлой кожей, корова светлой масти, сладкая белая вишня, белая глина, белая краска, белка, беличья шкурка (шкура), часть растущего дерева между корой и сердцевиной, заболонь, знахарка, колдунья, белое просо, меловая почва, белая глина;
*bĕlidlo:	белила (косметические), белая (минеральная) краска (для малярных работ, живописи), место на реке где отбеливают полотно (для отбеливания полотна, ткани, пряжи), белок, пудра, побелка, отбеливание, средство для беления (отбелки), белильная известь, косметическое средство (притирание для придания белизны лицу), девичник, чем можно белить (убелять);
*bĕlika:	горная береза, заболонь, слой дерева между корой и сердцевиной, беловатый плод (яблоко, черешня, слива), бузина, вид черешни (сливы), сорт яблок;
*bĕlikъ:	древесина между корой и сердцевиной, заболонь (дерева, у дуба), почка инжира, вид дуба, бельмо, белок яйца, огородная новь (место вновь назначенное под огород), поля (почва которых состоит из смешения глины с известью), стальной двуручный резец для очистки кож, самец белки;
*bĕlina:	белизна, сало (свиньи), вид шерстяного одеяла, белый цвет, белье, белое полотно, белое тело, белое мясо (у курицы), заболонь в дереве (древесине), беловатый плод, седина, сорт (белого) винограда, сивуха, свинцовые белила, бельмо, жирная (белая) земля, белое пятно, поповник (трава), белая овца (коза), белый холст, белая краска, белила, жерех;
*bĕliti:	белить (обычно известкой, полотно на солнце), очищать от кожи (коры, кожуры), чистить, шелушить (кукурузные початки), отбеливать (полотно, ткань), отделять, лущить, красить белилами, приукрашивать, раскалять, приправлять, сдобрять жиром, обдирать, лупить, снимать (кожу), чистить, стирать (белье), делать белым (подвергая особой обработке), говорить о ком-либо хорошо (с похвалой), окрашивать в белый цвет, убелять (умывая), лудить, свежевать;
*bĕlivo:	белое полотно, белье, молочные продукты, яйца, бельмо, глаукома, вещь подвергаемая белению, беление, белила;
*bĕlizna:	белизна, лесная поляна с хорошей травой, белок глаза, растение беловатого цвета, белая плева, белье, кожура (с фруктов), лыко, очищенная до белизны палочка, заболонь (в дереве), название разных мелких рыб (тарах, жерех, шереспер, язь), белый цвет, белок;
*bĕloba:	белизна, белый цвет, свинцовые белила, светлая окраска, белая краска, белила;
*bĕlobоkъ(jь):	скотина (у которой белая растительность в паху), имеющий белую окраску в паху, белобокий, белобокая (корова), с белыми боками;
*bĕlobordъ(jь)	белобородый (старец), седобородый, растение, с белой бородой;
*bĕlobrъvъjь:	белобровый, с русыми бровями;
*bĕlogolvъ(jь):	белоголовый, светловолосый, седоволосый, седоголовый, светлоголовый, седовласый, белоголовая утка, белоголовый белохвостик, растение, род ягод, пень (покрытый снегом как шапкой), с русой или седой головой;
*bĕlogǫzъ/*bĕlogǫza:	с белым задом, вид птицы, птица, каменка;
*bĕlogrivъ(jь):	белогривый, с седой гривой, со светлой гривой, светловолосый, белогривая (лошадь), с белой гривой;
*bĕlogъrdlъ(jь):	с белым горлом, белошеий, белогорлый;
*bĕloxvostъ(jь):	название птицы, белохвостый (бычок, беркут), птица, с белым хвостом;
*bĕlojьka:	мужская конопля (без семян), белая пшеница, белолицая и светловолосая жешцина, стебель цветущей конопли, вид (сорт скороспелой) конопли, животное белой масти;
*bĕloklenь:	'Acer campestre';
*bĕlokridlъ(jь):	белокрылый, снабженный белыми крыльями, птица (насекомое) с белыми крыльями;
*bĕlokvetъ(jь):	белый, белого цвета, нарцисс, с белыми цветами, растение (сорное с мелкими белыми цветочками с резким запахом, растущее по дорогам, на пустырях);
*bĕlolicьjь:	белолицый, у кого белое (чистое) лицо, с белым лицом;
*bĕlolikъ:	белолицый;
*bĕlolistъ(jь):	белолистый, с белыми листьями;
*bĕlonogъ(jь):	белоногий, растение, у кого белая нога (ноги);
*bĕloоkъ(jь):	с белыми кругами вокруг глаз (о животных, птицах), белоглазый, светлоглазый, рыба;
*bĕloǫsъ(jь):	белоусый, у кого белые (светлые) усы, прозвище человека с белыми волосами, с белыми (светлыми) усами;
*bĕloperъ(jь):	белоперый, птица с белым оперением, рыба с белыми плавниками, белоперая птица, стрела с белым оперением;
*bĕlopьrsъjь:	белогрудый;
*bĕlopьrsьnъ:	белогрудый;
*bĕlorępъ:	белохвостый;
*bĕloritъkа:	птица (с белым оперением на хвосте), название птицы, белый песочник, скакун;
*bĕloritъkъ:	название птицы;
*bĕloritь/ъ:	птица с белым хвостовым оперением, дроздовидная птица, птица из семейства соколиных;
*bĕlorǫkъ(jь):	белорукий, у кого белые руки;
*bĕlorunъ:	белорунный, с белым руном (белой шерстью);
*bĕlostь:	белизна, чистота, белый цвет, состояние (сущность, свойство) белого;
*bĕlosъrstъjь:	белошерстный;
*bĕlošь:	мужское имя, название потока, название горы, для обозначения объектов (существ) белого цвета (белой масти), белый камень, белый конь, ход рыбы стаей во время нереста, белки глаз, глаза, порода белых круглых слив, кофе с молоком;
*bĕlota:	белизна, белый предмет, животное (самец) белой масти, кличка, мужское имя, белый цвет, белота;
*bĕlotja:	белизна, белый цвет;
*bĕlotokъ:	бели, название женской болезни;
*bĕlovĕža:	название селения, деревня;
*Bĕlovoldъ:	Бѣловолодъ (имя);
*bĕlovolsъ(jь):	беловолосый, светловолосый, седоволосый, ковыль;
*bĕlozorъ(jь):	растение, птица (поющая на заре), белый сокол, имеющий светлые глаза;
*bĕlozǫbъ(jь):	белозубый, у кого белые зубы;
*bĕlǫda:	белая корова (овца), белая слива, глаза;
*bĕlǫga/*bĕlǫgъ:	белуга (самая огромная рыба Черного и Каспийского морей и устьев больших рек, млекопитающее из породы дельфиновых), белая свинья, название разных животных белой масти, сорная трава, вид сорняка (травы) которая растет на посевах, белый кабан, чайка, серовато-белая неплодородная почва, подзол, вода с примесью подзола, верхний слой земли, жерех;
*bĕlǫtъ/*bĕlǫta:	вид крупнозернистого кварца белого цвета, глазной белок, доска из чистого (здорового) дерева, растение, белила;
*bĕlǫtъkъ:	вид крупнозернистого кварца белого цвета, глазной белок, глаза;
*bĕluxa:	белая корова (коза, овца), блондинка, песчаная почва, мягкий белый камень, растение семейства сложноцветных, кошачья лапка двудомная, человек с очень светлыми волосами, белобрысый (белый) человек, белолицая (белая как снег) женщина, белуха;
*bĕluša:	кличка белой коровы (козы), сорт самого белого винограда (белых слив), глинисто-известняковая почва, теленок, собачья кличка, женщина легкого поведения, белая корова, блондинка;
*bĕlušь:	вид спаржи, конь белой масти, серебряная монетка, белый хлеб, блондин, лошадь (собака) светлой масти, белый (серый) конь, булочка;
*bĕlъgordъ:	Белград, Belohrad, Белгород;
*bĕlъ(jь):	белый, прозрачный, чистый, белки глаз, седой, бельмо, светлый, ясный, мелкая монета, имеющий цвет снега (молока, мела), молочные продукты, алебастр (известь, мел) растертые в порошок для беления комнат (печей), соль, рассвет, раннее утро;
*bĕlъka:	мелкое лесное животное куница, белка, животное ласка, белая овца, (яичный) белок, очищенный кусок,  вид речной рыбы, хищный лесной зверек, название животного, белок (глаза), белая курица, вид (пресноводной) рыбы, самка животного белой масти (с белой меткой, овца, кобыла, сука, кошка, корова, коза, курица, гусыня), вид ласточки, птица, рыба (пресноводная), белая (платяная) вошь, фрукты белого цвета, светловолосая женщина, вид верхней мужской одежды, серебряная монета, сорт груши (сливы), вид конопли, сорт белого мелкого винограда, бельмо, белая куропатка, сорт яблок (груш), белый хлеб, белая (женщина, корова, лошадь), вид белых мелких мучных изделий, белая мука, сорт ранней черешни, женщина (замужняя), булка, коврига, сова, лосось женского пола, насекомое, маленький зверек из отряда грызунов, беличья шкурка, растение;
*bĕlъkъ:	белок (яичный, в яйце, глазной), белый кремнистый камень, кварц, заболонь в древесине, сосна, бельмо, светловолосый парень, животное (лошадь, собака) светлой масти, густая и клейкая прозрачная жидкость в яйце, мучнистая часть всякого семени, болезнь дерева, бель, растение анемон, гора (вершина которой покрыта вечным снегом), гребень волны (покрытый белой пеной), мел (которым пишут, белят), мышьяк (используемый как лекарственное вещество или отрава), белый край в дубовой доске, растение семейства сложноцветных, мелкостойник едкий, приспособление для мятья кож (состоящее из полукруглого бруска с двумя перпендикулярно укрепленными в нем досками), белая часть лимонной кожуры;
*bĕlyni:	белизна, обширная прогалина, большой и сухой луг среди леса;
*bĕlyšь:	рыба, растение с белыми цветами, хлопчатобумажная ткань, лось, белок яйца;
*bĕlь:	одеяло из овечьей шерсти, заболонь (в дереве, древесине), шерстяное одеяло, толстое шерстяное покрывало, бельмо (на глазу), мучнистая роса, (свинцовые) белила, побелка, отбеливание, (белая) мука, белок, (животный, несоленый) жир (в сале), белый цвет, белизна, лучшая пшеничная (ржаная) мука, подбел, топленое свиное сало, подкожное сало (свиньи), белая древесина под корой, (мелкая частиковая) рыба (кроме осетровой), что-либо белое, мякоть, болото (покрытое мохом, на котором не растет ничего кроме моха), белая одежда, белое поле, главный цвет ткани, белило, белая вещь (или подвергаемая белению), белая краска, выбеленная льняная пряжа, сорт северных летних яблок (белый налив), слизистые или гнойные выделения, белый гребень волны, белая ткань, белые нитки (для шитья), часть дерева (следующая непосредственно за корой), белизна, полотно, (льняная домашнего прядения) отбеленная пряжа (используемая в качестве утка при узорном тканье), белая фабричная пряжа (идущая на уток при узорном тканье);
*bĕlьсе:	белок (в яйце, яйца);
*bĕlьсь:	водяная птица, шерстяное одеяло, (белая) лошадь, белок (в яйце, яичный), белый (человек, вол, конь), жеребец белой масти, белый мрамор, длинное зимнее одеяло из толегой белой шерсти, альбинос, белобрысый, таракан-прусак, сорт яблок, бельмо, заболонь (в древесине), сопля, беленый холст, холст для просушки зерна, монета, отбельщик, трава;
*bĕlьje:	бельё (все что обычно в домашнем хозяйстве делается из белой ткани, холста, полотна, камчатки или бранины, бумажных тканей, но вообще белое, и для стирки), белая краска, собачий помет (идущий на выделку кож средних веков), белила;
*bĕlьmĕjь:	пучеглазый мужчина;
*bĕlьmо:	бельмо, названии дерева, сорт белого винограда, белок (глаза, на глазу), умопомрачение, белизна, белое пятно, обман, (черная) белена, ива, бель, мязга, стойкое неспособное к просветлению помутнение роговой оболочки глаза, катаракт;
*bĕlьsko/*bĕlbskъ:	Белско, Belsko, Bielsko, Bilsko, Bielsk, Bielsko, Бѣлъскъ (неоднократно в качестве названий городов с раннего времени);
*bĕni?/*bĕnъky:	мотовило, сновальня, мялка, приспособление для тканья полотна или обработки льна, накладка на телегу (сделанная вроде санок, служит для перевозки сена, соломы);
*bĕsĕti:	бесеть, заболевать бешенством, сходить с ума, сердиться, неистовствовать, шалить, резвиться без меры;
*bĕsiti(sę):	бесноваться, неистовствоват, беситься, кичиться, раздражать, сходить с ума, кипеть от злости, сердиться, гневаться, быть в раздражении (в ярости), безудержно резвиться, шумно шалить, (о животных) заболевать бешенством (водобоязнью);
*bĕsovati:	период течки у собак (волков), шалить, куролесить, предаваться разврату, неистовствовать, спариваться (о собаках, волках), быть в исступлении (в бешенстве);
*bĕsъ:	бес, злой дух, демон, (дикая) ярость, злоба, смертельное заболевание животных (собак), бешенство (у животных, болезнь), черт, буйный нрав, шалость, юный возраст, буйство, нечистый, дьявол, о буйстве стихий, о душевном исступлении, (в христианских религиозных представлениях) дух тьмы (мрака, соблазняющий человека или причиняющий ему зло);
*bĕsьnĕti:	неистовствовать, сходить с ума, шалить, блажить, возиться, куролесить, проказничать, повесничать, беситься (о собаках, кошках), буйствовать, беситься, волноваться, бушевать;
*bĕsьnovati:	сходить с ума, впадать в бешенство, беситься, буйствовать;
*bĕsьnъ(jь):	неистовый, бешеный, разъяренный, буйный, взбесившийся, злой, взбешенный, распущенный, разнузданный, распоясавшийся, надменный, сумасшедший, горячий, пугливый (о коне), шальной, бесноватый, неспокойный, падучая болезнь, родимец (конвульсивные болезни, приписываемые суеверами бесовскому наваждению);
*bĕžajь:	бег;
*bĕžan(in)ъ:	беглец, бегун, трус;
*bĕžati:	бежать, убегать, избегать, течь, страдать от поноса, быстро двигаться в каком-либо направлении, стремительно направляться куда-либо, литься непрерывной струей (потоком), спасаться бегством вообще, ехать;
*bĕžika:	бегун;
*bĕžь/*bĕža:	бегство, стечение (народа), бег, движение бегом, беглый народ, бродяги, побежка (походка) лошади, аллюр, способ (характер) бега животного, укрытие, убежище;
*bĕžьсь:	беглец, (о животных) бегун, гонец;
*bĕžьlivъ:	быстрый, подвижный, беглый;
*bĕžьnъ(jь):	кратковременный, преходящий, бегучий, беглый, мимолетный, обычный, текучий, подвижный, привычный,  избегающий чего-либо, крыло невода (которое заносится в глубь воды), сторона невода (которую забрасывают заводом);
*bičь:	бич, плетка, (кожаная, ременная, веревочная) плеть (которой погоняют скотину), коса (из женских волос), кнут, произвольная мера длины, колотушка, (било, короткая часть, молотильного) цепа (которою молотят), длинная плеть из мелко свитых ремней или веревок, часть сукновального песта (при помощи которой он поднимается);
*bidlo:	гребень горы, горный хребет (с отрогами), конек крыши, маковица, маковка, овершье (о копне), верхняя продольная балка крыши, вершина горы (холма), верхушка копны, балка отделяющая жилую часть сельского дома от помещения для скота, крыша, перекрытие, перекладина грабель, артерия, клепало, механизм боя (часов), часть ткацкого станка, вешалка для одежды, жердь, насест, набилки, (дверной) косяк, бердо, брус в бороне (усаженный гвоздями), круглый брусок (облучок, крылья, отводы) в санях (предназначенные чтобы сани не опрокидывались), доска (в которую били для созывания в церковь или в трапезу, для оглашения молитв и для прочих надобностей в монастырях, употребляемая вместо колокола в монастырях), ударяющее орудие, пест, молоток (которым натягивают струны), клепало,  верхняя перекладина в ткацком станке (в решетчатой спинке кровати, в воротах), продольное боковое бревно в дверях от сарая (скрепляющее другие части дверей), в самодельной мялке трехгранная гладковыстроганная подвижная палка (при помощи которой мнут, треплют стебли пеньки, конопли), пест (которым толкут соль или перец), палка (которой обивают кукурузу);
*bidlьce:	палка, жердь, продольные бруски у бороны, деталь ткацкого станка (служащая для сбивания ниток), дощечки у саней (к которым привязывают верх, кибитку), чем бряцают на струнах, перила, (у люльки) рама, (у кровати, стула) спинка, края колыбели (скамьи, на которые опираются локтями), било, короткая часть цепа (которою молотят);
*bidlьnъ/*bidlьna:	что бьет или чем бьют, короткая палка цепа (связанная ременным приузом с держалкою), бич, битчик, приузень, киек, батог, навязень, висяга, ботало, колокольный язык, било, доска и колотушка или молоток ночных сторожей, клепало, верхняя челюсть мялицы, мялки для трепки пеньки и льна, пест, кий, чекмарь (в деревянной ступе), маслобойный снаряд, жом, гнет, пресс, облучок на санях, рама у кроснов (ткацкого стана, в которую вставляется бердо);
*bijakъ:	молотило (часть цепа, которой бьют по снопам), било, подвижная (более короткая) часть (молотильного) цепа (которою молотят), драчун, забияка, часть мельничного устройства;
*bijьca/*bijьсь:	драчун, буян, глашатай, пристав;
*birъ:	подать (в пользу священника или монастыря), налог, сбор в пользу священника (господина с каждого бракосочетания);
*bitelь:	кто бьет, чеканщик;
*biti:	бить (струей), ударять, убивать, биться (о сердце), драться, бороться, разрушать, уничтожать, колотить, ударяться, вламываться, вторгаться, молотить, наносить удары, звонить, умерщвлять, поражать (на охоте животных, птиц), наносить поражение, побеждать (на войне), раздроблять, дробить, с силой вырываться (о струе), ковать, лягать, вколачивать, (о рыбе) нерестовать;
*bitva:	битва, сражение, бой, борьба, драка, схватка, брань в больших размерах (где дерутся целые армии, полчища, ополчения), возня, суета, беспокойство, хлопоты, мученье, бойкий ребенок, побои;
*bitъ:	жердь, перекладина, рея, удар, драка;
*bitъka:	битва (крупных воинских сил), сражение, драка, нерест (рыб), стычка, бой, схватка (двоих или нескольких человек), физическое наказание, трепка, борьба, бой, свинец (вытянутый в прут по калибру ружья), кличка собаки, берестяная конусообразная корзина для собирания грибов, игральная кость из ступни животного, разбитое яйцо, битье, удар в игре латка, шило (которое отыскивают друг у друга играющие в игру шила бити), терниця (но с более широкой щелью для мечика), небольшая твердая плитка (которой дети играют в «классы»), приспособление для обработки пряжи;
*bitьcь:	борец, боец, драчун, забияка, било у цепа, каменоломщик;
*bitьje:	бой, драка, битье, механизм часового боя, удары, стук, избиение, стрельба, сражение, битва, побои, битьё, ударение, колоченье, битье;
*bitьnъ(jь):	боевой, связанный с битвой, доблестный, бравый, разбитной, битье, кнут, бич, каравай;
*bivojь:	Bivoj (имя);
*bivьсь/*bivьса:	буян, кто бьет, убивает, бьющий (игрок по мячу);
*blaznĕti:	сходить с ума, безумствовать, быть не в своем уме, быть душевнобольным, вести себя безрассудно, чудиться, мерещиться, представляться;