А (~13000)	и, притом, а притом, же, а, но, то, если
АБИѤ (857)	тогда, тотчас, теперь
АБО (1*)	так как, ибо
АБЫ (91)	чтобы, если бы
АВВА (283)	отец, настоятель монастыря, монах-старец
АВГОУСТЪ (138)	название месяца август
АВГОУСТЬСКЫИ (19)	августовский
АВДИѨНЕ (3*)	сторонники ереси связанной с именем Авдия
АВЪ (2*)	древнееврейское название одного из летних месяцев
АГЕМОНЪ (1*)	властитель, владыка
АГИОСЪ, АГИѨ (67)	святой
АГНИЦА (2*)	овца, овечка
АГНОСТѦНИНЪ (1*)	чтец в церкви, причетник
АГНЬЦА (1*)	овца, овечка
АГНЬЦЬ (142)	ягненок, часть просфоры с печатью вынимаемая для жертвоприношения во время литургии
АГНЬЧЬ (1*)	ягнячий
АГНѦ (9*)	ягненок
АДАМАНЕ (1*)	сторонники одной из ересей связанной с именем Адама
АДАМАНТИ (1*)	сторонники одной из ересей связанной с именем Оригена-Адаманта
АДАМАНТИНЪ (1*)	драгоценный камень, алмаз
АДАМАНТИСТЪ (1*)	драгоценный камень, алмаз
АДАМАНТЪ (4*)	драгоценный камень, алмаз
АДОВЪ (40)	адский
АДОВЬНЫИ (4)	адский
АДОВЬСКЫИ (1*)	адский
АДЪ (207)	ад, преисподняя
АДЬСКЫИ (6*)	адский
АѤРОВЪ (1*)	воздушный
АѤРОХОДИВЪ (1*)	способный воспарять духом
АѤРОХОДЬНЫИ (1*)	носящийся по воздуху
АѤРЪ (69)	воздух, небо, покров для церковных сосудов с причастием
АѤРЬНЫИ (1*)	воздушный
АѤРЬСКЫИ (4*)	воздушный, небесный
АѤРѢИСКЫИ (1*)	небесный
АѤТИАНЕ (5*)	сторонники одной из ересей ответвления арианства связанной с именем Аетия
АЖЕ (571)	если, так как, потому что, чтобы, что, который, тем более, а именно
АЗЪ (>2000)	я
АЗЪБОУКЪВЬНИКЪ (2*)	алфавит, буквы, алфавитный акростих
АЗЪБОУКЪВЬНЫИ (1*)	азбучный, буквенный
АЗЪБОУКЫ (1*)	азбука, буквы
АИЦЕ (2*)	яйцо
АКАДИМИѨ (1*)	академия, сад вблизи Афин, место собраний философов
АКИНФЪ (8)	вид ткани
АКИѨНЪ (4*)	океан
АКО (76)	как, подобно, что, чтобы
АКОНО (1*)	как будто
АКРОТОМЫИ (2*)	скалистый, обрывистый
АКЫ (1226)	как, подобно
АКЫИ (52)	какой
АКУНТЪ (1*)	драгоценный камень, гиацинт
АЛАВАСТРЪ (3*)	узкогорлый сосуд для хранения благовоний
АЛАКСАТИСѦ (1*)	облачаться
АЛАМЪ (4*)	вид нагрудного украшения
АЛЕ (4)	а, но
АЛИ (38)	или
АЛКАНИѤ (26)	голод, пост
АЛКАТИ (109)	испытывать голод, поститься
АЛКОНОСТЪ (3*)	морская птица
АЛКОТА (8)	голод, пост
АЛКОТЬНЪ (1*)	голодный
АЛКОУНОВЪ (1*)	относящийся к алконосту
АЛЛИЛОУАРЬ (19)	стих который читается в церкви перед чтением евангелия
АЛЛИЛОУИѨ (79)	вид церковного песнопения, хвала в честь бога
АЛОИНЪ (1*)	состоящий из сока алоэ
АЛТАРЬ (2*)	жертвенник, восточная часть церковного помещения отделенная иконостасом
АЛОУМПИѨДА (1*)	четырехлетний промежуток между олимпийскими играми
АЛФА (2*)	альфа, первая буква греческого алфавита
АЛЧЬ (1*)	голод
АЛЧЬБА (60)	голод, пост
АЛЧЬБЬНИКЪ (2*)	постник
АЛЧЬБЬНЫИ (3*)	голодный, относящийся к посту
АЛЧЬНОВАТИ (1*)	испытывать голод
АЛЧЬНЫИ (60)	голодный, постящийся, воздерживающийся от пищи
АЛЬ (3)	или
АЛѦ (3*)	или
АМБОЛЪ (3*)	амвон, возвышенная площадка в церкви перед царскими вратами
АМБОНЪ (30)	амвон, возвышенная площадка в церкви перед царскими вратами
АМИНЬ (327)	истинно, правильно, да будет так
AMO (26)	куда
АМОФОРЪ (9*)	наплечная часть архиерейского облачения
АМФУСИИ (1*)	полудрагоценный камень, аметист
АМѢФОУСТОНЪ (1*)	полудрагоценный камень, аметист
АНАГНОСАНЬѤ (1*)	чтение
АНАГНОСТЪ (3*)	чтец в церкви, причетник
АНАГНОСТЬСКЫИ (3*)	анагностский
АНАГРЪ (2*)	онагр, дикий осел
АНАЛАВЪ (5*)	четырехугольный плат с изображением креста который монахи носили под одеждой
АНАФЕМА (10)	анафема, проклятие, отлучение от церкви
АНАФОРА (2*)	вынос святых даров для причастия во время литургии
АНГЕЛИИ	ангельский
АНГЕЛИТИ (1*)	сторонники ереси связанной с обожествлением ангелов
АНГЕЛОВЪ (14)	ангельский
АНГЕЛОВЬЦИ (7)	сторонники ереси связанной с обожествлением ангелов
АНГЕЛООБРАЗЬНЪ (1*)	подобный ангелу
АНГЕЛОПОДОБЬНЫИ (2*)	подобный ангельскому
АНГЕЛЪ (1352)	ангел, в религиозной мифологии бесплотное сверхъестественное существо, вестник, сторонники ереси связанной с обожествлением ангелов
АНГЕЛЬСКЫ (6)	подобно ангелам, праведно
АНГЕЛЬСКЫИ (283)	ангельский, как у ангелов, подобный ангельскому, сторонники ереси связанной с обожествлением ангелов
АНГЕЛѢИ (1*)	более подобный ангелу
АНДРИАНТЪ (1*)	название сборника поучений Иоанна Златоуста
АНДРИЛИТЪ (1*)	название сборника поучений Иоанна Златоуста
АНО (1*)	а, но
АНТИМИСЪ (2*)	освященный плат который расстилается на престоле во время литургии
АНТИПАСХА (8)	первое воскресенье после пасхи
АНТИСТИХЪ (1*)	о соответствии строк в рукописной книге
АНТИФОНЪ (10)	стих из псалмов поющийся попеременно на двух клиросах
АНТИХРИСТОВЪ (4*)	антихристовый
АНТИХРИСТЪ (25)	противник Христа, антихрист
АНФРАКСЪ (3*)	драгоценный камень, рубин
АПЕЛИАНЕ (3*)	сторонники одной из ересей связанной с именем Апеллеса
АПОКАЛИПСИСЪ (1*)	апокалипсис, одна из книг Нового завета содержащая пророчества о конце мира
АПОЛИНАРИАТИ (1*)	сторонники одной из ересей связанной с именем Аполинария
АПОЛИНАРИИ (1*)	сторонники одной из ересей связанной с именем Аполинария
АПОЛИНАРИѨНЕ (9)	сторонники одной из ересей связанной с именем Аполинария
АПОСТОЛОВЪ (2*)	апостольский
АПОСТОЛЪ (>1500)	ученик Христа проповедовавший его учение, название книги деяний и посланий апостолов составляющей часть Нового завета
АПОСТОЛЬ (2*)	апостольский
АПОСТОЛЬНЫИ (1*)	апостольский
АПОСТОЛЬСКО (1*)	по примеру апостолов
АПОСТОЛЬСКЫ (9)	по примеру апостолов
АПОСТОЛЬСКЫИ (361)	апостольский, сторонники одной из ересей, название книги деяний и посланий апостолов составляющей часть Нового завета
АПОСТОЛЬСТВО (4*)	деятельность апостола, звание апостола
АПОТАКТИТИ (1*)	сторонники одной из ересей проповедовавшей возвращение к апостольской простоте и протестовавшей против омирщения церкви
АПРИЛИИ (1*)	название месяца, апрель
АПРИЛЬ (128)	название месяца, апрель
АПРИЛЬСКЫИ (19)	апрельский
АРГАНЪ (4*)	орган, вид музыкального инструмента
АРГАНЬСКЪ (2*)	органный
АРИГЕНИТИ (1*)	сторонники ереси связанной с именем Оригена
АРИѨНЕ (98)	сторонники одной из ересей, арианства
АРИѨНЬСКЫ (2*)	арианский
АРИѨНЬСКЫИ (16)	арианский
АРИѨНЬСТВО (2*)	ересь родоначальником которой был александрийский священник Арий проповедовавший неравенство бога-сына по отношению к богу-отцу
АРИѨНЬСТВОВАТИ (5)	следовать арианству, придерживаться арианской ереси
АРОМАТООБРАЗЬНЪ (1*)	имеющий запах подобный запаху благовоний
АРОМАТЪ (11)	ароматическое вещество, благовоние, приятный запах, аромат
АРОМАТЬСКЫИ (1*)	ароматический
АРТАВА (1*)	хлебная мера
АРТОУСЪ (1*)	освященный пасхальный хлеб из кислого теста
АРТОУСЬНЫИ (1*)	артоусный
АРХАНГЕЛОВЪ (6*)	архангельский
АРХАНГЕЛЪ (108)	архангел, один из чинов в иерархии небесных служителей бога
АРХАНГЕЛЬСКЫИ (9)	архангельский
АРХИДИѨКОНЪ (14)	архидьякон, старший дьякон
АРХИѤПИСКОПИѨ (2*)	архиепископская епархия, архиепископская власть
АРХИѤПИСКОПЛЬ (1*)	архиепископский
АРХИѤПИСКОПЪ (393)	архиепископ, старший епископ
АРХИѤПИСКОПЬСКЫИ (2*)	архиепископский
АРХИѤПИСКОПЬСТВО (1*)	сан архиепископа
АРХИѤРѢѤВЪ (6)	архиерейский
АРХИѤРѢИ (143)	первосвященник, архиерей, лицо имеющее одну из высших степеней священства
АРХИѤРѢИСКЫИ (6)	архиерейский
АРХИМАГЕРЪ (2*)	должность при восточном дворе, главный повар, начальник телохранителей
АРХИМАНДРИТИѨ (1*)	крупный монастырь управляемый архимандритом
АРХИМАНДРИТЪ (57)	архимандрит, настоятель монастыря обладающий священническим саном
АРХИМАНДРИЧЬ (1*)	архимандритский
АРХИСТРАТИГЪ (61)	военачальник (об архангелах Михаиле и Гаврииле — воеводах небесных сил)
АРХИСОУНАГОГЪ (1*)	старейшина еврейской религиозной общины
АРЦИБИСКОУПЪ (3*)	архиепископ римско-католической церкви
АСИАНЕ (1*)	представители одного из направлений гностицизма
АСИДА (1*)	вид птицы, аист
АСКИТРИѨ (1*)	девственница ведущая аскетический образ жизни
АСПИДА (19)	ядовитая змея
АСПИДОВЪ (6)	змеиный
АСПИДЪ I (4*)	ядовитая змея
АСПИДЪ II (1*)	полудрагоценный камень, яшма
АСПИДЬНЪ (1*)	змеиный
АСПИДЬНЫИ (1*)	из яшмы
АСПИСЪ (1*)	полудрагоценный камень, яшма
АСТРОНОМИѨ (2*)	астрономия, учение о звездах
АТИ (2*)	да, пусть
АТИКОВАРЬСТВИѤ (1*)	следование аттицизму(?)
АТО (3*)	да, пусть
АТЪ (17)	да, пусть
АТЬ (83)	да, пусть
АФИГЪГАНЕ (3*)	сторонники одной из ересей, неприкасаемые
АФИРА (3*)	вид пищи, овсяная каша
АХАТИНЬ (1*)	полудрагоценный камень, агат
АХАТИСЬ (2*)	полудрагоценный камень, агат
АЧЕ (54)	если
АЧИ (12)	если
АШОУТЬ (1*)	тщетно, напрасно
АЩЕ (~10000)	если, что, ли, разве
БАБА (39)	женщина, бабушка (мать отца или матери), повивальная бабка, женщина оказывающая помощь при родах
БАБИИ (1*)	бабушкин
БАБИНЪ (3*)	бабушкин
БАБИТИ (2*)	родить, быть роженицей
*БАБОУНИ (1*)	(=богомили и масалиане)
БАГРОРОДЬНЫИ (1*)	принадлежащий к царскому роду
БАГРЪ (12)	багровый цвет, багрянец, пряжа или ткань багрового цвета, одежда багрового цвета первоначально царская
БАГРѦНИЦА (22)	пряжа или ткань багрового цвета, одежда багрового цвета первоначально царская
БАГРѦНОВИНЬНЫИ (1*)	один из оттенков красного цвета
БАГРѦНОРОДЬНЫИ (5)	принадлежащий к царскому роду
БАГРѦНЫИ (9*)	багровый
БАГРѦНЬ (1*)	пряжа багрового цвета
БАДЬѨ (1*)	вид сосуда
БАЛОВЬСТВО (1*)	яд, отрава
БАЛЬСТВО (1*)	лекарство
БАНИТИСѦ (1*)	мыться
БАНОВЬНА (1*)	дочь бана
БАНЪ (2*)	правитель в Венгрии, Боснии, Хорватии, Далмации
БАНЬНИКЪ (2*)	банщик
БАНЬНЫИ (8*)	банный, очистительный
БАНѦ (97)	источник (по преимуществу теплый), баня, помещение, где моются и парятся, мытье
БАРМЫ (4*)	бармы, часть украшений парадной княжеской одежды, оплечье с драгоценностями
БАСКАКЪ (3*)	областной правитель в покоренных землях поставленный ханом для сбора дани и наблюдения за исполнением ханских распоряжений
БАСНОЗИЖДЬЦЬ (1*)	сочинитель сказок, мифов
БАСНОСЛАВИТИ (1*)	выдумывать, сочинять, проповедовать ложное учение
БАСНОСЛОВИВЪ (1*)	баснословный
БАСНОСЛОВИѤ (6)	выдумка, сказки, мифы, ложное учение
БАСНОСЛОВИМЫИ (1*)	баснословный
БАСНОСЛОВИТИ (21)	выдумывать, сочинять, проповедовать ложное учение
БАСНОСЛОВЬЦЬ (2*)	рассказчик сказок, мифов
БАСНОСТВОВАТИ (1*)	проповедовать что-либо ложное
БАСНОТВОРЕНИѤ (3*)	ложное учение
БАСНОТВОРИМЫИ (1*)	выдуманный, ложный
БАСНЬ (46)	вымысел, сказка, миф
БАСНЬНО (1*)	выдуманно, ложно, сказочно
БАСНЬНОМЪЛВИТИ (1*)	рассказывать о чем-либо неправдоподобном
БАСНЬНОСЛОВИѤ (1*	выдумка, сказки, мифы, ложное учение
БАСНЬНОСЛОВИТИ (1*)	выдумывать, сочинять, проповедовать ложное учение
БАСНЬНОСЛОУТИ (1*)	выдумывать, сочинять, проповедовать ложное учение
БАСНЬНЫИ (3*)	выдуманный, ложный, сказочный
БАСНЬСЛОУТИ (1*)	выдумывать, сочинять, проповедовать ложное учение
БАСНЬСТВОВАТИ (1*)	проповедовать что-либо ложное
БАТОГЪ (13)	палка, батог
БАТОЖЬНЫИ (1*)	батожный
БАТЬКО (1*)	отец
БАТѦ (1*)	отец
БАѨТИ (10)	выдумывать, рассказывать (сказки, небылицы)
БЕДРА (18)	бедро, часть ноги от таза до коленного сустава, лоно, тазобедренные кости с окружающими их тканями
БЕЗБЛАГОДАТИѤ (2*)	неблагодарность
БЕЗБЛАГОДАТЬНИКЪ (1*)	тот кто неблагодарен
БЕЗБЛАГОДАТЬНЫИ (1*)	неблагодарный
БЕЗБЛАЗНЬѤ (1*)	безгрешность
БЕЗБЛАЗНЬНО (1*)	безгрешно
БЕЗБЛАЗНЬНЫИ (3*)	недоступный соблазнам, искушениям, безгрешный
БЕЗБЛАЗНЬНѢ (1*)	безгрешно
БЕЗБЛАЗНѢ (1*)	безгрешно
БЕЗБЛОУДЬНО (1*)	безошибочно
БЕЗБОГЪ (2*)	безбожник
БЕЗБОЖИѤ (23)	безбожие, отрицание христианского учения, нечестивость
БЕЗБОЖЬНИКЪ (1*)	безбожник, иноверец
БЕЗБОЖЬНО (4)	безбожно, нечестиво
БЕЗБОЖЬНЫИ (121)	безбожный, иноверный, еретический, нечестивый
БЕЗБОЖЬСКЫ (5)	безбожно, нечестиво
БЕЗБОЖЬСТВИѤ (3)	безбожие, отрицание христианского учения, нечестивость
БЕЗБОЖЬСТВО (4*)	безбожие, отрицание христианского учения, нечестивость
БЕЗБОЖЬСТВЬНЪ (2*)	безбожный, иноверный, еретический, нечестивый
БЕЗБОЛѢЗНИѤ (3*)	бесчувственность, беспечность
БЕЗБОЛѢЗНО (1*)	безболезненно
БЕЗБОЛѢЗНЬНЫИ (2*)	безболезненный, бесчувственный
БЕЗБОЛѢЗНЬНѢИ (1*)	безболезненнее, бесчувственнее
БЕЗБОЛѢЗНЬСТВО (1*)	отсутствие сострадания, бесчувственность
БЕЗБОѨЗНЬНЫИ (3*)	бесстрашный, безбоязненный
БЕЗБОѨЗНЬСТВО (2*)	бесстрашие, безбоязненность
БЕЗБРАДЬНЪ (1*)	безбородый
БЕЗБРАЧЬѤ (2*)	безбрачие
БЕЗБРАЧЬНЫИ (1*)	не состоящий в браке
БЕЗБРАЧЬСТВИѤ (1*)	безбрачие
БЕЗБѢДЬНО (3*)	безопасно, безнаказанно
БЕЗБѢДЬНЫИ (6)	безопасный, безнаказанный, не заслуживающий наказания, не вменяемый в вину
БЕЗБѢДЬСТВО (1*)	безопасность, отсутствие опасностей бед
БЕЗВАЗНЬСТВО (1*)	несчастье, неудача
БЕЗВЕЩЕСТЬ (1*)	бестелесность (о духах, бесплотных существах)
БЕЗВЕЩЬНЫИ (3*)	невещественный, бесплотный, нематериальный
БЕЗВЕЩЬСТВЬѤ (2*)	бездействие
БЕЗВЕЩЬСТВЬНЫИ (5*)	невещественный, бесплотный, нематериальный
БЕЗВИНЬНЫИ (23)	невиновный, не содержащий вины
БЕЗВЛАЖЬНО (1*)	без влаги, воды
БЕЗВЛАСТЬѤ (1*)	безвластие, отсутствие руководства
БЕЗВЛАСТЬНЪ (5*)	недействительный, не имеющий силы, неправомочный
БЕЗВОДИѤ (10)	отсутствие воды
БЕЗВОДЬНЫИ (18)	безводный, сухой
БЕЗВРЕДЬНЫИ (4)	невредимый
БЕЗВРЕМЕНЬНО (2*)	безвременно, вечно, несвоевременно, неуместно, неподобающе
БЕЗВРЕМЕНЬНЫИ (14)	вневременный, вечный, не ограниченный временем, несвоевременный, неуместный, неподобающий
БЕЗВѢРИѤ (2*)	неверие в христианское учение
БЕЗВѢРЬНЫИ (1*)	неверующий
БЕЗВѢРЬСТВИѤ (1*)	неверие в христианское учение
БЕЗВѢСТЬѤ (1*)	неизвестность
БЕЗВѢСТЬНО (2*)	неизвестно, неведомо, безвестно
БЕЗВѢСТЬНЫИ (13)	неизвестный, неведомый, безвестный
БЕЗВѢТРЬѤ (1*)	безветрие
БЕЗГАЗЬНА (1*)	незыблемо, невредимо
БЕЗГЛАВЬНИЦИ (2*)	еретики принадлежащие к секте отрекшейся от своего патриарха главы
БЕЗГЛАВЬНЫИ (25)	безумный, безрассудный, еретики принадлежащие к секте отрекшейся от своего патриарха главы
БЕЗГЛАСЬѤ (2*)	безмолвие, молчание
БЕЗГЛАСЬНО (1*)	негромко
БЕЗГЛАСЬНЫИ (15)	лишенный способности говорить, не обладающий даром речи, немой, беззвучный, неслышный
БЕЗГНѢВИѤ (4*)	отсутствие гнева, незлобивость
БЕЗГОВѢНЬѤ (1*)	непочтительность, небрежность
БЕЗГОДИѤ (5*)	несвоевременность, неблагоприятное время
БЕЗГОДОСЛОВЬНИКЪ (1*)	кто говорит не вовремя, некстати
БЕЗГОДЬНЫИ (12)	несвоевременный, неуместный, неподобающий
БЕЗГОДЬНѢ (1*)	несвоевременно, неуместно, неподобающе
БЕЗГОЛОВИѤ (1*)	опасность для жизни, беда, несчастье
БЕЗГРАДЬНИКЪ (2*)	кто не имеет родины, своего города
БЕЗГРѢШЬѤ (1*)	безгрешность, непорочность
БЕЗГРѢШЬНО (1*)	безгрешно, непорочно
БЕЗГРѢШЬНЫИ (37)	безгрешный, непорочный
БЕЗГРѢШЬСТВЬНЫИ (1*)	безгрешный
БЕЗГЪРДОСТЬНЫИ (1*)	негордый, смиренный
БЕЗГЪРДЬѤ (1*)	отсутствие гордости
БЕЗДОБЬ (1*)	напрасно, бесполезно
БЕЗДОБЬНЫИ (1*)	напрасный, бесполезный
БЕЗДОМЪ (1*)	бездомный человек
БЕЗДОМЪКЪ (5*)	бездомный человек
БЕЗДРОДЬНО	неблагородно
БЕЗДРОДЬНЫИ	незнатный, безродный, бесплодный
БЕЗДОУШЬНИИ (1*)	не имеющий души
БЕЗДОУШЬНО (1*)	бездушно
БЕЗДОУШЬНЫИ (86)	не имеющий души, без души
БЕЗДЪЖИѤ (17)	бездождие, засуха
БЕЗДЪНА (42)	бездонная пропасть, бездна, огромное количество, множество
БЕЗДЪНЫИ (5*)	бездонный
БЕЗДЪНЬѤ (1*)	бездна
БЕЗДЪНЬНЫИ (1*)	безмерный
БЕЗДЬРЗНОВЕНЬНО (1*)	недерзающе, недерзостно
БЕЗДЬРЗНОВЕНЬНЪ (1*)	недерзающий, недерзостный
БЕЗДѢВЬСТВИТИ (2*)	лишить девственности
БЕЗДѢИСТВЬНЪ (1*)	бездействующий
БЕЗДѢЛЬѤ (2*)	безделье, праздность, занятость незначительными делами, пустяками
БЕЗДѢЛЬНО (4*)	бесполезно, попусту, безыскусственно, просто
БЕЗДѢЛЬНЫИ (31)	пребывающий без дела, не работающий, праздный, бессильный, не способный сделать что-либо, находящийся без употребления, ненужный, безуспешный, бесполезный, напрасный, простой, обычный
БЕЗДѢЛЬНѢ (3*)	бесполезно, зря
БЕЗДѢЛЬСТВО (1*)	бесполезность, ненужность
БЕЗДѢЛЬСТВОВАТИ (2*)	бездействовать, не прилагать труда (стараний), заниматься бесполезным делом
БЕЗДѢТЕЛЬНЪ (1*)	бездействующий, не способный к действию
БЕЗДѢТЬНЫИ (2*)	бездетный
БЕЗДѢТЬСТВО (1*)	неимение детей
БЕЗЖЕРЕЛЬНЫИ (2*)	неслышный, беззвучный
БЕЗЖИВОТЬНЪ (1*)	безжизненный
БЕЗЗАВИСТИѤ (1*)	отсутствие зависти, независтливость
БЕЗЗАВИСТЬНО (4*)	не вызывая зависти
БЕЗЗАВИСТЬНѢИ (1*)	более обильный
БЕЗЗАДЬНИЦА (2*)	имущество оставшееся после смерти владельца у которого нет прямых наследников
БЕЗЗАДЬЩИНА (3*)	выморочное имение
БЕЗЗАЖЮ (1*)	без наследников
БЕЗЗАЗОРЬНО (1*)	вне подозрения (подозрений)
БЕЗЗАЗОРЬНЫИ (5*)	находящийся вне подозрения, не возбуждающий подозрений
БЕЗЗАКОНЕНЬѤ (1*)	нарушение догматов христианства, законов установленных церковной или светской властью
БЕЗЗАКОНИѤ (403)	нарушение догматов христианства, законов установленных церковной или светской властью
БЕЗЗАКОНИКЪ (1*)	человек не принадлежащий к христианам, нарушающий догматы христианства (законы церковной или светской власти), грешник
БЕЗЗАКОНИТИ (2*)	нарушать догматы христианства, законы церковной или светской власти, совершать противозаконные поступки
БЕЗЗАКОНОВАТИ (2*)	нарушать догматы христианства, законы церковной или светской власти, совершать противозаконные поступки
БЕЗЗАКОНЫИ (5*)	беззаконный, противозаконный, противоречащий христианскому учению или законам, установленным церковной или светской властью
БЕЗЗАКОНЬНИКЪ (47)	человек не принадлежащий к христианам, нарушающий догматы христианства (законы церковной или светской власти), грешник
БЕЗЗАКОНЬНО (30)	беззаконно, противозаконно, противоречаще христианскому учению или законам, установленным церковной или светской властью
БЕЗЗАКОНЬНОВАТИ (38)	нарушать догматы христианства, законы церковной или светской власти, совершать противозаконные поступки
БЕЗЗАКОНЬНЫИ (268)	беззаконный, противозаконный, противоречащий христианскому учению или законам, установленным церковной или светской властью
БЕЗЗАКОНЬНѢ (4)	беззаконно, противозаконно, противоречаще христианскому учению или законам, установленным церковной или светской властью
БЕЗЗАКОНЬНѢИ (3*)	беззаконнее, противозаконнее, более противоречащее христианскому учению или законам, установленным церковной или светской властью
БЕЗЗАКОНЬСТВИѤ (1*)	нарушение догматов христианства, законов установленных церковной или светской властью
БЕЗЗАКОНЬСТВО (2*)	нарушение догматов христианства, законов установленных церковной или светской властью
БЕЗЗАКОНЬСТВОВАТИ (18)	нарушать догматы христианства, законы церковной или светской власти, совершать противозаконные поступки
БЕЗЗАСТОУПЬНЪ (1*)	беззащитный
БЕЗЗРАЧЬНЪ (1*)	не имеющий прежнего облика
БЕЗЗЪЛОБИВЫИ (22)	незлобивый, кроткий, простодушный, безгрешный
БЕЗЗЪЛОБИѤ (41)	незлобивостъ, кротость, простодушие, безгрешность
БЕЗЗЪЛОБЬНО (2*)	беззлобно (незлобиво, кротко, простодушно, безгрешно)
БЕЗЗЪЛОБЬНЫИ (19)	незлобивый, кроткий, простодушный, безгрешный
БЕЗЗЪЛОБЬНѢ (1*)	беззлобно (незлобиво, кротко, простодушно, безгрешно)
БЕЗЗЪЛОБЬСТВО (1*)	незлобивостъ, кротость, простодушие, безгрешность
БЕЗЗЬРѢНЬѤ (1*)	(?)
БЕЗИЗВѢСТЬНЫИ (1*)	охотно, безоговорочно делающий что-л
БЕЗИЗМѢНИКЪ (1*)	неимущий, бедняк
БЕЗИЗТЬЛѢНЬѤ (2*), -Ѩ 	нетленность
БЕЗИЗТЬЛѢНЬНЪ (1*)	нетленный, вечный
БЕЗИЗХОДАТАИСТВЬНЫИ (1*)	не имеющий посредников, непосредственный
БЕЗИЗЦѢЛЬНО (1*)	неисцелимо, неисправимо
БЕЗИЗЦѢЛЬНЪ (1*)	неисцелимый, неисправимый
БЕЗИМЕНЬНЫИ (4)	не имеющий имени (названия)
БЕЗИМѢНЬНИКЪ (1*)	неимущий, бедняк
БЕЗИМѢНЬСТВО (2*)	бедность
БЕЗКАЗНЬНЪ (1*)	безнаказанный
БЕЗКВАСЬНЫИ (2*)	неквашеный, пресный, чистый
БЕЗКЛИРОСЬНЪ (1*)	вне клира, отлученный от клира
БЕЗКОЛѢНЬНЪ (1*)	не имеющий коленей
БЕЗКОНЬНЫИ (1*)	вечный, искони существующий
БЕЗКОНЬЧАѤМЫИ (1*)	бесконечный
БЕЗКОНЬЧЬНИИ (3*)	бесконечный, не имеющий конца (предела)
БЕЗКОНЬЧЬНО (4)	бесконечно, без конца (предела)
БЕЗКОНЬЧЬНЫИ (11О)	бесконечный, не имеющий конца (предела)
БЕЗКОРЕНЬНЪ (1*)	не имеющий корней
БЕЗКРАМОЛЬНЫИ (1*)	мирный, безмятежный, безропотный
БЕЗКРАСЬНЪ (1*)	неприукрашенный, обезображенный
БЕЗКРОВЬНЫИ (1*)	не имеющий крова (приюта)
БЕЗКРЪВЬНЫИ (14)	бескровный, без крови
БЕЗКЪЗНЬНЫИ (1*)	бесхитростный
БЕЗЛИЧЬНЫИ (3*)	безобразный, неприличный
БЕЗЛОУКАВЬСТВИѤ (1*)	отсутствие злобы (коварства)
БЕЗЛОУНЬНЪ (1*)	безлунный
БЕЗЛЪЖЬНО (2*)	неложно, истинно
БЕЗЛЪЖЬНЫИ (1*)	неложный, истинный
БЕЗЛЬСТЬНЪ (1*)	непогрешимо, безошибочно
БЕЗЛѢПИЦА (2*)	что не подобает (не следует) делать, нелепость
БЕЗЛѢПИЧЬНЫИ (2*)	неподобающий, нелепый
БЕЗЛѢПОТА (1*)	безобразие
БЕЗЛѢПОТЬНО (1*)	нелепо, неподобающе, неблаговидно, безобразно
БЕЗЛѢПОТЬНЫИ (4*)	неподобающий, неблаговидный, безобразный
БЕЗЛѢПОТЬСТВО (1*)	безобразие
БЕЗЛѢПОТЬСТВОВАТИ (1*)	вести себя неподобающе (безобразно)
БЕЗЛѢПЪ (1*)	нелепый, глупый
БЕЗЛѢПЬСТВОВАТИ (1*)	вести себя неподобающе (безобразно)
БЕЗЛѢТЬНЫИ (11)	не ограниченный временем, вечный
БЕЗЛѢЧЬНЫИ (1*)	неизлечимый
БЕЗЛЮБЬЗЬНѢ (1*)	(?)
БЕЗМАТЕРЬНЪ (1*)	не имеющий матери
БЕЗМАТЕРЬСТВО (1*)	неимение матери
БЕЗМИЛОСТИВЪ (3*)	немилосердный, жестокий
БЕЗМИЛОСТИВЬНО (1*)	немилосердно, жестоко
БЕЗМИЛОСТИВЬНЪ (3*)	немилосердный, жестокий
БЕЗМИЛОСТЫНИ (1*)	немилосердие, безжалостность, отсутствие подаяния
БЕЗМИЛОСТЬНО (1*)	немилосердно, жестоко
БЕЗМИЛОСТЬНЫИ (2*)	немилосердный, жестокий
БЕЗМИЛОСЬРДИѤ (2*)	немилосердие, жестокость
БЕЗМИРЬНЫИ (1*)	непримиримый
БЕЗМОЛЬБЬНИКЪ (1*)	отшельник (давший обет молчания)
БЕЗМОУДРЬѤ (1*)	неразумие, глупость
БЕЗМОУЖЬѤ (1*)	отсутствие мужества
БЕЗМОУЖЬНО (1*)	немужественно
БЕЗМОУЖЬНЪ (2*)	немужественный, незамужняя, девственная
БЕЗМОУТЬНЫИ (1*)	невозмутимый, безмятежный
БЕЗМЪЛВИѤ (41)	безмолвие, молчание, безропотность, спокойствие
БЕЗМЪЛВИТИ (1*)	безмолвствовать, жить отшельником (давшим обет молчания)
БЕЗМЪЛВЬНИКЪ (10)	отшельник, давший обет молчания
БЕЗМЪЛВЬНО (3*)	безмолвно, безмятежно, тихо, спокойно
БЕЗМЪЛВЬНЫИ (10)	безмолвный, безмятежный, тихий, спокойный
БЕЗМЪЛВЬСТВИѤ (1*)	безмолвие, молчание, безропотность, спокойствие
БЕЗМЪЛВЬСТВО (2*)	безмолвие, молчание, безропотность, спокойствие
БЕЗМЪЛВЬСТВОВАТИ (27)	безмолвствовать, жить отшельником (давшим обет молчания)
БЕЗМЪЛЧЬНО (1*)	неумолкающе
БЕЗМЪЛЧЬНЪ (1*)	неумолкающий
БЕЗМЬЗДИѤ (2*)	бескорыстие, нетребование вознаграждения
БЕЗМЬЗДЬНИКЪ (20)	бессребреник, бескорыстный человек
БЕЗМЬЗДЬНИЧЬСКЫИ (1*)	бессребрениковый, бескорыстный
БЕЗМЬЗДЬНО (4)	бескорыстно, безвозмездно
БЕЗМЬЗДЬНЫИ (11)	бескорыстный, безвозмездный
БЕЗМѢНА (1*)	(?)
БЕЗМѢНЪ (1*)	мера веса
БЕЗМѢРЕНИѤ (1*)	неумеренность, преувеличение
БЕЗМѢРИѤ (9)	безмерность, беспредельность, неумеренность, чрезмерность
БЕЗМѢРЬНО (3*)	сильно, безмерно, чрезмерно
БЕЗМѢРЬНЫИ (46)	неизмеримый, огромный, неумеренный, чрезмерный
БЕЗМѢРЬСТВО (2*)	неумеренность, чрезмерность
БЕЗМѢСТЬѤ (1*)	лишение должности (места)
БЕЗМѢСТЬНО (2*)	неуместно, неподобающе
БЕЗМѢСТЬНЫИ (13)	неуместный, неподобающий
БЕЗМѦТЕЖЬНИКЪ (1*)	невозмутимый, спокойный человек
БЕЗМѦТЕЖЬНО (7)	безмятежно, невозмутимо, спокойно
БЕЗМѦТЕЖЬНЫИ (12)	безмятежный, невозмутимый, спокойный
БЕЗНАДЕЖЬНИКЪ (1*)	кто лишен надежды
БЕЗНАДЕЖЬНЫИ (1*)	без надежды, лишенный надежды
БЕЗНАПАСТЬНЪ (1*)	недоступный искушениям
БЕЗНАРѦДЬѤ (1*)	отсутствие порядка (присмотра)
БЕЗНАЧАЛО (1*)	отсутствие начала
БЕЗНАЧАЛЬѤ (3*)	безначалие, безвластие
БЕЗНАЧАЛЬНО (1*)	без начала, вечно
БЕЗНАЧАЛЬНЫИ (78)	не имеющий начала, существующий вечно
БЕЗНАЧАЛЬСТВИѤ (2*)	безначалие, безвластие
БЕЗНЕВѢСТЬНАѨ (2*)	девственная, безбрачная (о богородице)
БЕЗНЕДОУЖЬНЫИ (1*)	без недугов, болезней
БЕЗНРАВЬНЫИ (2*)	порочный, безнравственный
БЕЗНРАВЬСТВИѤ (1*)	безнравственность
БЕЗНОУЖЬНЫИ (2*)	не связанный с притеснением (насилием)
БЕЗОБРАЗИѤ (6)	безобразие, неподобающее (неприличное) поведение, уродство, увечье
БЕЗОБРАЗЬНЫИ (5*)	не имеющий облика (формы, очертаний), безобразный, неподобающий
БЕЗОБЬЩЬНЪ (2*)	отлученный
БЕЗОПЫТЬНЪ (1*)	непытливый, неискушенный
БЕЗОРОУЖИТИ (1*)	делать безоружным
БЕЗОТВѢТЬНЫИ (1*)	не имеющий оправдания, непростительный
БЕЗОЧЬѤ (1*)	бесстыдство
БЕ3ОЧЬСТВО (1*)	бесстыдство
БЕЗПАГОУБЬНЪ (2*)	не подверженный гибели, без убытка, без ущерба
БЕЗПАКОСТЬѤ (1*)	отсутствие препятствий (помех)
БЕЗПАКОСТЬНО (3)	беспрепятственно, безопасно
БЕЗПАКОСТЬНЫИ (2*)	беспрепятственный, безопасный
БЕЗПАКОСТЬНѢ (1*)	беспрепятственно, безопасно
БЕЗПАМѦТЬНЪ (6*)	забытый, забывающий
БЕЗПЕНЬНЫИ (1*)	свободный от уплаты пени
БЕЗПЕРЕСТАНИ (2*)	непрестанно, постоянно
БЕЗПЕЧАЛИѤ (18)	отсутствие забот (огорчений), беспечность, отсутствие беспокойства
БЕЗПЕЧАЛОВАТИ (1*)	не заботиться, быть беспечным
БЕЗПЕЧАЛЬНИКЪ (1*)	учитель, наставник
БЕЗПЕЧАЛЬНО (2*)	беспечально, беззаботно, беспечно, бесстрастно, невозмутимо
БЕЗПЕЧАЛЬНЫИ (20)	беспечальный, беззаботный, беспечный, бесстрастный, невозмутимый
БЕЗПЕЧАЛЬСТВО (1*)	невозмутимость, бесстрастие
БЕЗПЕЧЬНѢИ (1*)	более надежный (уверенный)
БЕЗПИЩЬѤ (1*)	отсутствие пищи, голодание
БЕЗПИЩЬНЫИ (2*)	не имеющий пищи, обходящийся без пищи
БЕЗПЛАВЬНЫИ (1*)	неблуждающий, нерасплывающийся
БЕЗПЛОДОВИТЪ (1*)	бесплодный
БЕЗПЛОДЬѤ (3*)	бесплодие, неплодородие
БЕЗПЛОДЬНЫИ (8)	бесплодный, неплодородный
БЕЗПЛОДЬСТВО (2*)	бесплодие
БЕЗПЛЪТЬѤ (2*)	отсутствие плотских (чувственных) страстей
БЕЗПЛЪТЬНЫИ (86)	бесплотный, бестелесный, невещественный
БЕЗПОВЕЛѢНЫИ (1*)	неразрешенный, недозволенный
БЕЗПОКРОВЬНЫИ (7)	лишенный крова, бездомный, бесприютный
БЕЗПОЛЬЗЬНЫИ (1*)	бесполезный
БЕЗПОЛЬЗЬНЬНЫИ (1*)	бесполезный
БЕЗПОМОЩЬНЫИ (3*)	беспомощный, слабый
БЕЗПОНОСЬНЪ (1*)	не вызывающий укора (осуждения), безупречный
БЕЗПОРОЧЬНО (1*)	непорочно, безукоризненно
БЕЗПОРОЧЬНЫИ (3*)	непорочный, безукоризненный
БЕЗПОСТАВЬНЫИ (1*)	непостоянный, изменчивый
БЕЗПОСТЕЛИѤ (1*)	лишение имущества, нищета
БЕЗПОТРѢБЬНО (1*)	ненужно
БЕЗПРАВИЛЬНЫИ (1*)	незаконный, действующий против правил
БЕЗПРАВЬДИѤ (1*)	беззаконие, грех, несправедливость
БЕЗПРАВЬДОВАТИ (3*)	грешить, поступать беззаконно (несправедливо)
БЕЗПРАВЬДЬНО (2*)	неправедно, грешно
БЕЗПРАВЬДЬНЫИ (1*)	неправедный, грешный
БЕЗПРАВЬДЬНѢИ (1*)	более неправедный (грешный)
БЕЗПРЕСТАНИ (100)	непрестанно, постоянно
БЕЗПРЕСТАНЬ (1*)	непрестанно, постоянно
БЕЗПРЕСТАНЬНО (2*)	беспрестанно, постоянно
БЕЗПРЕСТАНЬНЫИ (7)	беспрестанный, постоянный
БЕЗПРИОБЬЩЕНЫИ (3*)	отлученный от церкви, лишенный причастия
БЕЗПРИОБЬЩЕНЬНЪ (1*)	отлученный от церкви, лишенный причастия
БЕЗПРИОБЬЩЕНЬНѢ (1*)	неканонично, вопреки церковным правилам (будучи отлученным)
БЕЗПРИОБЬЩЬНИКЪ (1*)	кто отлучен (лишенный причастия)
БЕЗПРИРОЧЬНЪ (1*)	не имеющий недостатков (пороков)
БЕЗПРИЧАСТЬНЪ (1*)	лишенный причастия, отлученный
БЕЗПРОМЫСЛЬНЫИ (1*)	необеспеченность
БЕЗПОУТЬѤ (3*)	бездорожье, отсутствие пути
БЕЗПОУТЬНЫИ (1*)	бездорожный, не имеющий пути (дороги)
БЕЗРАЗСЪМЫСЛЬНЫИ (1*)	лишенный разума, неразумный
БЕЗРАЗОУМЬѤ (1*)	незнание
БЕЗРАЗОУМЬНО (1*)	без понимания (разумения)
БЕЗРАЗОУМЬНЫИ (2*)	неразумный, непостижимый разумом
БЕЗРАТЬѤ (1*)	неучастие в борьбе, миролюбие
БЕЗРОДЬНО (1*)	неблагородно
БЕЗРОДЬНЫИ (3*)	незнатный, безродный, бесплодный
БЕЗРОУКЫИ (1*)	безрукий
БЕЗСАНОВЬСТВО (1*)	недостойность
БЕЗСАНЬНЫИ (1*)	беспорядочный (?)
БЕЗСКВЬРНО (1*)	непорочно, безукоризненно, безупречно
БЕЗСКВЬРНЫИ (17)	непорочный, безукоризненный, безупречный
БЕЗСКВЬРНЬНЫИ (26)	непорочный, безукоризненный, безупречный
БЕЗСКОУДЬНЪ (1*)	нескудный, обильный
БЕЗСКЪРБЬНО (1*)	без скорби, беспечально
БЕЗСКЪРБЬНЪ (3*)	без скорби, беспечальный
БЕЗСЛАВИѤ (8)	отсутствие славы, безвестность, бесславие, позор, дурная слава
БЕЗСЛАВЛѦТИ (1*)	позорить, лишать доброй славы
БЕЗСЛАВЬНЪ (3*)	неизвестный, забытый, бесславный, достойный осуждения, кому не воздали почестей
БЕЗСЛОВЕСИѤ (11)	неразумие, безрассудство
БЕЗСЛОВЕСТВОВАТИ (3*)	заниматься скотоложством
БЕЗСЛОВЕСЬНО (7)	неразумно, бессмысленно
БЕЗСЛОВЕСЬНЫИ (121)	неразумный, бессмысленный
БЕЗСЛОВЕСЬНѢ (3)	неразумно, бессмысленно
БЕЗСЛОВЕСЬНѢИ (4)	более неразумный (бессмысленный)
БЕЗСЛОВЬСТВОВАТИ	заниматься скотоложством
БЕЗСРЕБРЬНИКЪ (1*)	бессребреник, бескорыстный человек
БЕЗСТРАСТИѤ (71)	отсутствие страданий, бесстрастность, невозмутимость, отсутствие страстей
БЕЗСТРАСТЬНО (9)	бесстрастно, не подверженно страстям
БЕЗСТРАСТЬНЫИ (41)	не подверженный страданию, нечувствительный к страданию, не испытавший страдания, не подверженный страстям
БЕЗСТРАХОВАНИѤ (2*)	бесстрашие, безбоязненность	
БЕЗСТРАШИѤ (15)	бесстрашие, безбоязненность
БЕЗСТРАШЬНЪ (1*)	безопасный
БЕЗСТРОѤНИѤ (1*)	беспорядочность
БЕЗСТОУДИѤ (36)	бесстыдство, стыд, срам
БЕЗСТОУДОВАТИ (1*)	быть бесстыдным
БЕЗСТОУДЬНИКЪ (1*)	бесстыдный человек
БЕЗСТОУДЬНО (29)	бесстыдно, постыдно
БЕЗСТОУДЬНЫИ (47)	бесстыдный, постыдный
БЕЗСТОУДЬНѢ (6)	бесстыдно, постыдно
БЕЗСТОУДЬНѢИ (5)	бесстыдней, постыдней
БЕЗСТОУДЬСТВО (5)	бесстыдство
БЕЗСТОУДЬСТВОВАТИ (8)	вести себя бесстыдно, бесстыдничать
БЕЗСТОУЖЬ (1*)	бесстыдный
БЕЗСОУДЬНЫИ (3)	оправданный без суда
БЕЗСОУМЬНѢНЫИ (1*)	недремлющий
БЕЗСЪБЛАЗНЫИ (1*)	не вводящий в соблазн
БЕЗСЪБОРЬНЪ (1*)	отлученный от церковного общения
БЕЗСЪВѢДЬНЫИ (1*)	непостижимый
БЕЗСЪВѢТОВАНИѤ (2*)	неследование советам, безрассудство, своеволие
БЕЗСЪВѢТЪ (1*)	неследование советам, безрассудство, своеволие
БЕЗСЪВѢТЬѤ (1*)	неследование советам, безрассудство, своеволие
БЕЗСЪВѢТЬНЫИ (5*)	не получающий советов, действующий по своей воле, безрассудный, огражденный от козней (злого умысла), недоступный для злоумышления
БЕЗСЪВѢТЬСТВО (1*)	неследование советам, безрассудство, своеволие
БЕЗСЪМОУТЬНЫИ (1*)	несмущаемый, безмятежный
БЕЗСЪМЫСЛЬНЪ (1*)	безрассудный
БЕЗСЪМЬРТИѤ (44)	бессмертие
БЕЗСЪМЬРТИТИ (1*)	делать бессмертным
БЕЗСЪМЬРТЬНО (1*)	бессмертно, не подверженно смерти
БЕЗСЪМЬРТЬНЫИ (158)	бессмертный, не подверженный смерти
БЕЗСЪМЬРТЬНЬНЫИ (1*)	бессмертный
БЕЗСЪМЬРТЬНѢ (1*)	бесконечно, вечно
БЕЗСЪМЬРТЬНѢИ (1*)	бессмертней, более не подверженный смерти
БЕЗСЪМЬРТЬСТВО (5)	бессмертие
БЕЗСѢМЕНЬНЫИ (2*)	возникший без семени
БЕЗТВАРЬ (1*), -И	отсутствие порядка, беспорядочность, неустройство
БЕЗТРОУДЬНО (1*)	без труда
БЕЗТРОУДЬНЫИ (1*)	не требующий усилий, труда
БЕЗТЬЛѢНЬНЫИ (3*)	не подверженный тлению, нетленный, вечный
БЕЗТѢЛЕСЬНЫИ (17)	бестелесный, бесплотный, нематериальный
БЕЗОУМИѤ (155)	неразумие, безрассудство, безумство, сумасшествие, слабоумие
БЕЗОУМЛЬ (2*)	безумный
БЕЗОУМЬНИКЪ (2*)	безумный, безрассудный человек
БЕЗОУМЬНО (13)	безумно, безрассудно, неразумно
БЕЗОУМЬНОВАТИ (1*)	поступать безрассудно, безумствовать
БЕЗОУМЬНЫИ (178)	лишенный ума, сознания, безумный, безрассудный, неразумный, слабоумный, умалишенный
БЕЗОУМЬНѢ (4*)	безумно, безрассудно, неразумно
БЕЗОУМЬНѢИ (2*)	безумней, безрассудней, неразумней
БЕ3ОУМЬСТВО (3)	неразумие (о язычниках)
БЕЗОУМЬСТВОВАТИ (2*)	поступать безрассудно, безумствовать
БЕЗОУПОСТАСЬНЪ (1*)	не являющийся ипостасью
БЕ3ОУПЪВАНЬСТВО (1*)	отсутствие надежды, безнадежность
БЕЗОУСТАВЬНЪ (1*)	противоречащий установленному порядку (правилу, обычаю)
БЕЗОУТѢШЬНЫИ (1*)	безутешный
БЕЗХОДОТАИНЬСТВЬНО (1*)	непосредственно
БЕЗХОУЛЬНЫИ (1*)	беспорочный, безупречный
БЕЗЦѢЛЬНЫИ (1*)	неисцелимый
БЕЗЦѢНЫИ (1*)	неоценимый, бесценный
БЕЗЦѢНЬНЫИ (15)	неоценимый, бесценный
БЕЗЧАДИѤ (11)	бездетность
БЕЗЧАДИТИСѦ (1*)	лишиться детей
БЕЗЧАДОВАТИ (2*)	лишать детей
БЕЗЧАДЬНЫИ (14)	бездетный, бесплодный
БЕЗЧАДЬСТВО (2*)	бездетность
БЕЗЧАСТИѤ (1*)	несчастие
БЕЗЧАСТЬНИКЪ (2*)	несчастный человек
БЕЗЧАСТЬНЫИ (4*)	не имеющий доли (части), чуждый, непричастный к чему-либо
БЕЗЧЕЛЕНЬНЪ (1*)	нечленимый (?)
БЕЗЧЕЛОВѢЧЕНИѤ (3*)	бесчеловечность
БЕЗЧЕЛОВѢЧИѤ (13)	бесчеловечность
БЕЗЧЕЛОВѢЧЬНЫИ (19)	бесчеловечный, жестокий
БЕЗЧЕЛОВѢЧЬНѢИ (1*)	бесчеловечней, более жестокий
БЕЗЧЕЛОВѢЧЬСТВО (2*)	бесчеловечность
БЕЗЧЕНЬѤ (2*)	нарушение порядка, бесчинство
БЕЗЧИНИѤ (71)	нарушение порядка, бесчинство
БЕЗЧИНЫИ (1*)	нарушающий порядок, бесчинный, неподобающий
БЕЗЧИНЬНИКЪ (5)	кто нарушает порядок
БЕЗЧИНЬНО (5)	нарушающе порядок, бесчинно, неподобающе
БЕЗЧИНЬНЫИ (53)	нарушающий порядок, бесчинный, неподобающий
БЕЗЧИНЬНѢ (2*)	нарушающе порядок, бесчинно, неподобающе
БЕЗЧИНЬНѢИ (2*)	более нарушающий порядок (бесчинный, неподобающий)
БЕЗЧИНЬСТВОВАТИ (2*)	нарушать порядок (правила)
БЕЗЧИНЬСТВЬНО (1*)	беспорядочно
БЕЗЧИСЛИѤ (5*)	безмерность, бесконечность, неумеренность
БЕЗЧИСЛЬНО (7)	бесчисленно, неисчислимо
БЕЗЧИСЛЬНЫИ (140)	бесчисленный, неисчислимый
БЕЗЧИСЛЬНѢИ (1*)	бесчисленней, неисчислимей
БЕЗЧИСМЕНЫИ (3*)	бесчисленный, неисчислимый
БЕЗЧИСМЕНЬНЫИ (1*)	бесчисленный, неисчислимый
БЕЗЧОУВЬСТВЬНО (1*)	бесчувственно, равнодушно
БЕЗЧОУВЬСТВЬНЪ (3)	лишенный способности чувствовать, бесчувственный
БЕЗЧЬСТВИѤ (4*)	нечестие, дурной поступок
БЕЗЧЬСТВОВАНЫИ (9)	обесчещенный, опозореный
БЕЗЧЬСТВОВАТИ (75)	не почитать, обесчестить, опозорить
БЕЗЧЬСТВОВАТИСѦ (13)	не быть почитаемым, подвергаться поруганию, позориться
БЕЗЧЬСТВОУѤМЪ (3*)	непочитаемый, бесчестный, позорный
БЕЗЧЬСТВЬНЪ (1*)	позорящий, оскорбительный
БЕЗЧЬСТИВЫИ (2*)	нечестивый
БЕЗЧЬСТИѤ (141)	бесчестие, дурная слава, позор, нечестивое поведение, дурной поступок
БЕЗЧЬСТИТИ (2*)	не почитать, обесчестить, опозорить
БЕЗЧЬСТЬНЫИ (34)	непочитаемый, презираемый, пользующийся дурной славой, позорный, недостойный, позорящий, не чтущий, нечестивый
БЕЗЧЬСТЬНЪИ (3*)	более (непочитаемый, презираемый, пользующийся дурной славой, позорный, недостойный)
БЕЗЪ (~3000)	без (отсутствие кого или чего)
БЕЗЪѨЗЫЧЬНЪ (2*)	без слов, не выраженный словами
БЕЛЕНЪ (3*)	ядовитое растение, белена
БЕРЕГЪ (135)	берег, высокий берег, обрыв
БЕРЕГЫНИ (3*)	мифологическое существо, русалка
БЕРЕЖИСТЪ (1*)	с гористыми берегами
БЕРЕЗОВЪ (1*)	березовый
БЕРЕЗОЗОЛЪ (1*)	название одного из весенних месяцев
БЕРЕМѦ (4*)	груз, ноша, тяжесть
БЕРЕСТО (1*)	береста, письмо на бересте
БЕСОУРМЕНИНЪ (12)	нехристианин, иноверец
БЕСОУРМЕНЪКА (1*)	нехристианка, иноверка
БЕСОУРМЕНЬСКЫИ (4*)	нехристианский, иноверский
БЕСѢДА (217)	беседа, разговор, общение, объединение, собрание людей определенного мировоззрения
БЕСѢДОВАНИѤ (14)	беседа, собеседование, разговор
БЕСѢДОВАНЫИ (4*)	собеседованный, обговоренный, сообщеный
БЕСѢДОВАТИ (360)	беседовать, разговаривать, общаться
БЕСѢДОВЬНИКЪ (2*)	автор поучений, бесед
БЕСѢДОВЬНЫИ (1*)	относящийся к беседе
БЕСѢДЬНИКЪ (2*)	собеседник, сотоварищ
БИѤМЫИ (71)	ударяемый, колотимый, постукиваемый, вбиваемый, вколачиваемый, разбиваемый
БИѤНИѤ (11)	ударение, колочение, стучание, вбивание, вколачивание
БИѤНЪ (119)	ударен, избит, убит, уничтожен
БИИЦА (1*)	драчун, зачинщик драк
БИЛИНЧЬ (1*)	улика, примета, признак (по которому можно узнать что-либо)
БИЛО (36)	деревянная (металлическая) доска (для подачи сигналов ударами)
БИЛЬНЫИ (2*)	бильный
БИРИЧЬ (6*)	представитель княжеской власти (занимающийся объявлением распоряжений)
БИСКОУПОВЪ (2*)	епископский
БИСКОУПЪ (5)	епископ (духовное лицо имеющее высшую степень священства)
БИСЬРЪ (56)	жемчужина, жемчуг, изделие из жемчуга, украшение
БИСЬРѦНЫИ (1*)	жемчужный
БИТИ (547)	ударять, колотить, стучать, вбивать, вколачивать, наносить удары, избивать, поражать (с помощью метательного оружия), разбивать, убивать, уничтожать (убить, уничтожить)
БИТИѤ (1*)	просьба, челобитная
БИТИСѦ (377)	драться, бороться, вести бой, сражаться, воевать, ударяться, выражать скорбь (муку)
БИТЫИ (2*)	удареный, избитый
БИЧЬ (5*)	бич, плеть
БЛАГО I (336)	благо, добро, проявления блага (добра), что служит удовлетворению материальных потребностей, богатство, изобилие
БЛАГО II (34)	хорошо
БЛАГОБОѨЗНИВЫИ (42)	почитающий бога, набожный, благочестивый
БЛАГОБОѨЗНИВѢИ (1*)	более почитающий бога (набожный, благочестивый)
БЛАГОБОѨЗНО (1*)	набожно, благочестиво
БЛАГОБОѨЗНЬѤ (1*)	преданность богу, набожность, благочестие
БЛАГОБОѨЗНЬНО (5*)	набожно, благочестиво
БЛАГОБОѨЗНЬНЫИ (4*)	почитающий бога, набожный, благочестивый
БЛАГОБОѨЗНЬНѢИ (1*)	более почитающий бога (набожный, благочестивый)
БЛАГОБОѨЗНЬСТВО (38)	преданность богу, набожность, благочестие
БЛАГОБОѨЗНЬСТВОВАТИ (2*)	почитать бога, быть набожным, благочестивым
БЛАГОБОѨНИѤ (4*)	преданностъ богу, набожность, благочестие
БЛАГОВАЗНИВЪ (1*)	счастливый, преуспевающий
БЛАГОВАЗНЬСТВО (1*)	счастье, удача
БЛАГОВЕЛИКЪ (1*)	великий, могущественный
БЛАГОВЕСЕЛИѤ (3*)	веселье, радость
БЛАГОВЕСЕЛИТИ (1*)	радовать, веселить
БЛАГОВЕЩИѤ (1*)	благоденствие, процветание, счастье
БЛАГОВЕЩЬСТВО (3*)	положительное природное свойство, способность
БЛАГОВИДЬНЪ (1*)	благообразный
БЛАГОВИДѢНИѤ (1*)	красота, гордость, слава
БЛАГОВИНЬНЪ (1*)	хорошо видимый
БЛАГОВОЛЕНИѤ (42)	расположение, любовь, милость, благосклонность (бога)
БЛАГОВОЛЕНЫИ (1*)	доброжелательный, благосклонный
БЛАГОВОЛИТИ (39)	быть расположенным, проявлять расположение, хотеть
БЛАГОВОЛЬНЫИ (2*)	благой, добродетельный
БЛАГОВОЛЬНѢ (1*)	благожелательно
БЛАГОВОЛЬСТВО (2*)	благое (доброе) дело, добрая воля
БЛАГОВОНИѤ (2*)	благоухание, аромат
БЛАГОВОНЬНО (1*)	благоуханнно, с приятным запахом, ароматно
БЛАГОВОНЬНЫИ (17)	издающий благоухание (приятный запах), ароматный
БЛАГОВОНЬНѢ (1*)	благоуханнно, с приятным запахом, ароматно
БЛАГОВОНЬНѢИ (2*)	издающий более приятный запах, ароматней
БЛАГОВОНЬСТВО (2*)	благоухание, аромат
БЛАГОВОНѦНИѤ (1*)	благоухание, аромат
БЛАГОВОНѦТИ (1*)	издавать приятный запах, аромат, благоухать
БЛАГОВРЕМЕНЬНО (2*)	своевременно, уместно
БЛАГОВРЕМЕНЬНЪ (5*)	своевременный, уместный
БЛАГОВѢРИѤ (97)	набожность, благочестие, истинная вера, православие
БЛАГОВѢРОВАТИ (1*)	быть благочестивым
БЛАГОВѢРЬНО (6)	преданно истинной вере, православно, благочестиво
БЛАГОВѢРЬНЫИ (204)	преданный истинной вере, православный, благочестивый
БЛАГОВѢРЬНѢ (2*)	преданно истинной вере, православно, благочестиво
БЛАГОВѢРЬСТВО (3*)	благочестие
БЛАГОВѢСТВИѤ (1*)	предзнаменование, предсказание
БЛАГОВѢСТВОВАТИ (8*)	сообщать радостную весть
БЛАГОВѢСТИТИ (45)	сообщить радостную весть, провозгласить
БЛАГОВѢСТИТИСѦ (1*)	быть возвещенным (провозглашенным)
БЛАГОВѢСТОВАНИѤ (15)	доброе известие, доброе предзнаменование, евангелие
БЛАГОВѢСТОВАТИ (26)	сообщать радостную весть
БЛАГОВѢСТОВАТИСѦ (1*)	быть возвещаемым, провозглашаемым
БЛАГОВѢСТЬѤ (1*)	евангелие
БЛАГОВѢСТЬНИКЪ (5*)	провозвестник добра
БЛАГОВѢСТЬНИЦ[А (1*)	провозвестница добра
БЛАГОВѢСТЬНЪ (1*)	имеющий чистую совесть
БЛАГОВѢЩАНИѤ (1*)	провозглашение, сообщение радостной вести
БЛАГОВѢЩАНЫИ (1*)	провозглашено, сообщено о радостной вести
БЛАГОВѢЩАНЬНЪ (1*)	содержащий добрую весть
БЛАГОВѢЩАТИ (2*)	провозглашать, сообщать радостную весть
БЛАГОВѢЩЕНИѤ (69)	добрая весть
БЛАГОВѢЩЕНЬНЫИ (2*)	содержащий добрую весть
БЛАГОГЛАГОЛИВЪ (2*)	красноречивый
БЛАГОГЛАСЬНѢИ (1*)	более звучный, громкий
БЛАГОГОВѢИНО (7)	благоговейно, набожно, почитающе бога
БЛАГОГОВѢИНЫИ (48)	благоговейный, набожный, почитающий бога
БЛАГОГОВѢИНЬСТВО (3*)	почитание бога
БЛАГОГОВѢИНѢ (1*)	благоговейно, набожно, почитающе бога
БЛАГОГОВѢИНѢИ (1*)	более благоговейный (набожный, почитающий бога)
БЛАГОГОВѢНИѤ (24)	благоговение, почитание бога
БЛАГОГОВѢНЬНЫИ (3*)	благоговейный, набожный, почитающий бога
БЛАГОГОВѢТИ (1*)	благоволить, быть благосклонным
БЛАГОГОРЬКЪ (1*)	неприятный, тяжелый
БЛАГОГОТОВЪ (2*)	благолепный, доступный, открытый для добра
БЛАГОДАВЬЦЬ (1*)	кто делает добро (оказывает благодеяния)
БЛАГОДАНЬСТВО (1*)	ниспосланный свыше дар, благодеяние
БЛАГОДАРЕНИѤ (96)	благодарение, дар, благодарность, хвала, прославление (по отношению к богу), причастие, благодеяние, услуга
БЛАГОДАРЕНЪ (1*)	благодарен
БЛАГОДАРИВЫИ (2*)	благодарный
БЛАГОДАРИѤ (9)	ниспосланный свыше дар, благодать, благодарность
БЛАГОДАРИМЪ (1*)	одаряемый, награждаемый
БЛАГОДАРИТИ (141)	одаривать, награждать, выражать благодарность, благодарить
БЛАГОДАРИТИСѦ (1*)	быть благодарным
БЛАГОДАРОВАТИ (3*)	даровать, благодарить
БЛАГОДАРЬНИКЪ (3*)	кто благодарен
БЛАГОДАРЬНО (4*)	благодарно
БЛАГОДАРЬНЫИ (20)	исполненный благодарности
БЛАГОДАРЬНѢ (4*)	благодарно
БЛАГОДАРЬСТВИѤ (5*)	благодарность, причастие
БЛАГОДАРЬСТВИТИ (8*)	выражать благодарность, благодарить
БЛАГОДАРЬСТВО (2*)	благодарность
БЛАГОДАРЬСТВОВАНЪ (1*)	благодарен
БЛАГОДАРЬСТВОВАТИ (13)	выражать благодарность, благодарить
БЛАГОДАРЬСТВЬНО (1*)	исполнено благодарности
БЛАГОДАРЬСТВЬНЫЙ (2*)	исполненный благодарности
БЛАГОДАРЬСТВЬНѢ (2*)	исполнено благодарности
БЛАГОДАТЕЛЬ (32)	кто делает добро (оказывает благодеяния)
БЛАГОДАТЕЛЬНЪ (1*)	исполненный добра (блага)
БЛАГОДАТЕЛЬСТВО (3*)	благодеяние
БЛАГОДАТИВЫИ (1*)	исполненный добра (блага)
БЛАГОДАТИѤ (3*)	ниспосланный свыше дар, благодеяние
БЛАГОДАТЬ (905)	добро, благодеяние, благодать, дар, милость (божья), благодарность, благодарение
БЛАГОДАТЬЛИВЪ (1*)	исполненный добра (блага)
БЛАГОДАТЬНИКЪ (2*)	кто делает добро (оказывает благодеяния)
БЛАГОДАТЬНО (1*)	исполнено добра (блага)
БЛАГОДАТЬНЫИ (51)	исполненный добра (блага)
БЛАГОДАТЬНѢ (1*)	исполнено добра (блага)
БЛАГОДАТЬНѢИ (2*)	более исполненный добра (блага)
БЛАГОДАТЬСТВО (4*)	ниспосланный свыше дар, благодеяние, богатство
БЛАГОДАТЬСТВОВАТИ (4)	благодетельствовать, совершать благодеяния
БЛАГОДАТЬСТВОУѤМЪ (2*)	облагодетельствоваемый, получаемый благодеяния
БЛАГОДВИЖЕНЬѤ (1*)	усердие, послушание
БЛАГОДОСТОИНЫИ (1*)	благопристойный
БЛАГОДОСТОИНЬСТВО (2*)	благопристойность
БЛАГОДОУШЕВЬНЫИ (1*)	молитвенный
БЛАГОДОУШИѤ (11)	спокойствие, радость
БЛАГОДОУШЬНИКЪ (1*)	кто обладает душевным спокойствием
БЛАГОДОУШЬНЫИ (8)	спокойный
БЛАГОДОУШЬСТВО (2*)	великодушие
БЛАГОДОУШЬСТВОВАТИ (1*)	успокаивать, радовать
БЛАГОДЬНЬѤ (8)	благоденствие, процветание, успех, богатство
БЛАГОДЬНЬНЫИ (1*)	благоденствие, процветание
БЛАГОДЬНЬСТВО (5*)	благоденствие, процветание, успех, богатство
БЛАГОДЬНЬСТВОВАТИ (3*)	благоденствовать, процветать, жить в счастье
БЛАГОДЬНЬСТВОУѤМЪ (1*)	благоденствуем, процветаем, живем в счастье
БЛАГОДЬРЗНОВЕНЬНО (2*)	откровенно, прямодушно
БЛАГОДЬРЗНОУСТЬНЪ (1*)	смелый, откровенный в высказываниях
БЛАГОДЬРЗЫИ (1*)	откровенный
БЛАГОДЬРЗЬНЪ (1*)	откровенный, прямодушный
БЛАГОДѢИСТВО (2*)	благодеяние
БЛАГОДѢИСТВОВАНЬѤ (1*)	совершение благодеяния
БЛАГОДѢИСТВОВАТИ (6*)	делать добро
БЛАГОДѢИСТВОВАТИСѦ (1*)	пользоваться услугами, быть благодетельствуемым
БЛАГОДѢИСТВОУѤМЪ (1*)	делаем добро
БЛАГОДѢИСТВЬНЪ (1*)	исполненный добра, блага
БЛАГОДѢЛАТИ (1*)	делать добро, благодетельствовать
БЛАГОДѢЛЕСЬНЫИ (1*)	благодеяние
БЛАГОДѢЛЬѤ (2*)	благодеяние, польза
БЛАГОДѢЛЬНЫИ (1*)	полезный
БЛАГОДѢТЕЛЬ (3*)	благодетель
БЛАГОДѢТЕЛЬНИЦА (1*)	благодетельница
БЛАГОДѢТЕЛЬСТВО (1*)	благодеяние
БЛАГОДѢТЕЛЬСТВОВАТИ (1*)	делать добро, благодетельствовать
БЛАГОДѢТЬ (77)	добро, благодеяние, благодать, дар, милость (божья), приятность, добродетель, благодарность
БЛАГОДѢТЬѤ (1*)	благодать, дар
БЛАГОДѢТЬНИКЪ (1*)	о благодарности
БЛАГОДѢТЬНО (1*)	легко, без труда
БЛАГОДѢТЬНЫИ (2*)	исполненный благодати
БЛАГОДѢТЬСТВОВАТИ (3*)	благодетельствовать
БЛАГОДѢТЬСТВОВАТИСѦ (1*)	быть облагодетельствованным
БЛАГОДѢѨНИѤ (76)	доброе дело, благотворительность, благодеяние, добродетель, благодать
БЛАГОДѢѨНЫИ (3*)	облагодетельствованый
БЛАГОДѢѨНЬНИКЪ (1*)	кто делает добро
БЛАГОДѢѨНЬНЫИ (3*)	делающий добро
БЛАГОДѢѨНЬНѢ (1*)	добродетельно
БЛАГОДѢѨТИ (11)	делать добро, благодетельствовать
БЛАГОЖИЗНЬѤ (6)	благоденствие
БЛАГОЖИТИ (2*)	благоденствовать, жить благочестиво
БЛАГОЖИТЬѤ (2*)	благоденствие
БЛАГОЗАКОНЬѤ (1*)	законноетъ, справедливость
БЛАГОЗАКОНЬНЫИ (1*)	законный, справедливый
БЛАГОЗАРЬНЪ (1*)	прозрачный, чистый
БЛАГОЗЪВАНЬНЪ (1*)	призванный на добрые дела
БЛАГОЗЬДАТИСѦ (1*)	быть упорядоченным
БЛАГОИЗВОЛЕНИѤ (6*)	благосклонность, благоволение, уважение
БЛАГОИЗВОЛЕНЫИ (1*)	хвалебный
БЛАГОИЗВОЛИВЫИ (1*)	прославленный
БЛАГОИЗВОЛИТИ (19)	быть довольным, соизволить, соблаговолить, благоволить, быть благосклонным к кому-либо
БЛАГОИЗКОУСИТИ (1*)	прославить
БЛАГОИЗКОУСЬНЪ (8)	прославленный, окруженный уважением
БЛАГОИЗКОУШЕНЬѤ (2*)	слава, уважение
БЛАГОИЗПОВѢДЬНИКЪ (1*)	правдивый, откровенный человек
БЛАГОИЗПОВѢДЬНО (1*)	правдиво, откровенно
БЛАГОИЗПРАВЛѦЮЩЬ (1*)	исправляющий, улучшающий
БЛАГОКЛѦТВЬНО (1*)	с верностью клятве
БЛАГОКОНЬНЪ (1*)	славящийся конями
БЛАГОКОНЬЧЬНЪ (1*)	преходящий
БЛАГОКОНЬЧЬНѢИ (1*)	более преходящий
БЛАГОКРАСЬНЫИ (2*)	красивый, прекрасный
БЛАГОКРАШЕНЬѤ (1*)	красота
БЛАГОКРОТОСТЬ (1*)	кротость, спокойствие
БЛАГОКРОТЪКЫИ (1*)	кроткий, спокойный
БЛАГОКРѢПЪКЪ (1*)	крепкий, сильный
БЛАГОКЪРМИТИСѦ (1*)	воспринимать, впитывать все хорошее
БЛАГОЛИЧЬНЫИ (2*)	красивый, прекрасный
БЛАГОЛИЧЬНѢ (2*)	красиво, благопристойно
БЛАГОЛОЖЬНО (1*)	удобно, подходяще
БЛАГОЛОУЧИТИ (1*)	делать понятным, легко доступным
БЛАГОЛѢПИѤ (8)	благообразие, красота
БЛАГОЛѢПЫИ (1*)	благопристойный
БЛАГОЛѢПЬНО (4*)	благообразно, хорошо, как подобает
БЛАГОЛѢПЬНЫИ (16)	благообразный, красивый, прекрасный, великолепный
БЛАГОЛѢПЬНѢ (4*)	благообразно, хорошо, как подобает
БЛАГОЛЮБИВИИ (1*)	добродетельный
БЛАГОЛЮБИВЫИ (3*)	любящий делать добро, добродетельный
БЛАГОЛЮБИѤ (1*)	благая, искренняя любовь
БЛАГОЛЮБИТИ (1*)	любить добро, быть добродетельным
БЛАГОЛЮБЪВЬНѢ (1*)	с любовью к добру
БЛАГОЛЮБЬЗНЫИ (1*)	боголюбивый, добрый
БЛАГОЛЮБЬЗНѢ (2*)	боголюбиво, с любовью
БЛАГОЛЮБЬНЪ (1*)	добрый, проникнутый любовью к добру
БЛАГОЛЮБЬНѢ (2*)	с любовью к добру
БЛАГОЛЮБЬЦЬ (2*)	кто любит делать добро
БЛАГОМИЛОВАНЬѤ (1*)	милосердие, мягкость
БЛАГОМОЛИТВЬНЫИ (1*)	молитвенный, связанный с молитвой
БЛАГОМОЛИТИСѦ (1*)	страстно желать, обращаться с мольбами
БЛАГОМОЩЬНЫИ (1*)	сильный, мощный
БЛАГОМОУДРЫИ (2*)	благоразумный
БЛАГОМОУДРЬНЫИ (1*)	благоразумный
БЛАГОМОУДРЬСТВОВАТИ (2*)	быть благоразумным
БЛАГОМОУЖИѤ (1*)	мужество, храбрость
БЛАГОМОУЖЬСТВО (1*)	мужество, храбрость
БЛАГОНАДЕЖЬНЫИ (3*)	исполненный надежды (на спасение)
БЛАГОНАСЛѢДЬѤ (1*)	духовное богатство, духовное наследие
БЛАГОНАСѢѨТЕЛЬ (1*)	распространитель доброго
БЛАГОНАЧИНАНИѤ (Р)	доброе дело, благодеяние
БЛАГОНОСИВЫИ (1*)	вдохновленный богом
БЛАГОНОСЬНЫИ (1*)	вдохновленный богом
БЛАГОНРАВИѤ (1*)	добродетель
БЛАГОНРАВО (1*)	добродетельно, справедливо
БЛАГОНРАВЬНЪ (4*)	добродетельный
БЛАГОНРАВЬСТВО (2*)	добронравие, покорность, добродетельность
БЛАГООБРАЗИѤ (1*)	благопристойность
БЛАГООБРАЗЬНО (7)	с достоинством, достойным образом
БЛАГООБРАЗЬНЫИ (32)	красивый, почтенный, уважаемый, достойный
БЛАГООБРАЗЬНѢ (11)	достойным образом
БЛАГООБРАЗЬНѢИ (3*)	более красивый (почтенный, уважаемый, достойный)
БЛАГООБЫЧЬНО (1*)	в соответствии с принятыми обычаями
БЛАГООБѢЩАНЬѤ (1*)	благое обещание
БЛАГООБѢЩАНЬНЪ (1*)	откровенный
БЛАГООЖИВИТИ (1*)	вести праведную жизнь
БЛАГООТЬЧИТЪ (1*)	знатного происхождения, благородный
БЛАГОПЛЕМЕНЬСТВО (1*)	хорошее потомство, счастье в детях
БЛАГОПЛОДИѤ (3*)	плодородие
БЛАГОПЛОДЬНЫИ (2*)	имеющий хорошие плоды
БЛАГОПОВИНЬНЪ (1*)	скромный, сдержанный
БЛАГОПОВѢДАНИѤ (1*)	сообщение, известие о благе
БЛАГОПОДАТЕЛЬНЪ (1*)	щедрый
БЛАГОПОДАТИВЫИ (1*)	щедрый
БЛАГОПОДАТЛИВЪ (1*)	щедрый
БЛАГОПОДВИГНОУТИСѦ (1*)	проявить склонность к добрым делам
БЛАГОПОДВИЖЬНИКЪ (1*)	кто склонен к совершению добрых дел, поступков
БЛАГОПОДВИЖЬНО (1*)	с готовностью на добрые дела, поступки
БЛАГОПОДВИЖЬНЫИ (4)	склонный, стремящийся к добру
БЛАГОПОДВИЗАНЬѤ (1*)	склонность к добру
БЛАГОПОДВИЗАТИСѦ (1*)	совершать добрые дела
БЛАГОПОДОБЬѤ (1*)	соблюдение правил, послушание
БЛАГОДОДОБЬНО (1*)	подобающе, соответствующе
БЛАГОПОДОБЬНЪ (1*)	подобающий, соответствующий
БЛАГОПОКАРѦТИСѦ (1*)	быть покорным, послушным
БЛАГОПОКАѨНЬНѢ (1*)	с раскаянием
БЛАГОПОКОРЕНИѤ (6*	послушание, повиновение
БЛАГОПОКОРЬЛИВЪ (1*)	покорный, послушный
БЛАГОПОКОРЬНИКЪ (2*)	кто покорен, послушен
БЛАГОПОКОРЬНЪ (1*)	покорный, послушный
БЛАГОПОЛАГАТИСѦ (1*)	стремиться к благу, к добру
БЛАГОПОЛОЖЬНЫИ (5)	надлежащий, подходящий
БЛАГОПОЛОЖЬНѢ (2*)	надлежаще, подходяще
БЛАГОПОЛОУЧАТИ (1*)	украшать
БЛАГОПОЛОУЧЕНЫИ (1*)	благополучный
БЛАГОПОЛОУЧЕНЬѤ (2*)	благополучие
БЛАГОПОЛОУЧЬЛИВЫИ (1*)	приносящий благополучие
БЛАГОПОЛЬЗЬНЪ (2*)	приносящий пользу
БЛАГОПОСЛОУШАНИѤ (8)	послушание, повиновение, покорность
БЛАГОПОСЛОУШЬЛИВЫИ (8)	послушный, покорный
БЛАГОПОСЛОУШЬЛИВЬНѢ (1*)	с покорностью, с послушанием
БЛАГОПОСЛОУШЬНО (1*)	послушно, покорно
БЛАГОПОСЛОУШЬНЪ (2*)	послушный, покорный
БЛАГОПОСТИЖЬНО (1*)	легко доступно
БЛАГОПОСТИЖЬНЪ (1*)	легко доступный
БЛАГОПОСТРАДАНЬѤ (1*)	труд, подвиг во имя блага, забота о благе
БЛАГОПОТРЕБИѤ (1*)	полезность, пригодность
БЛАГОПОТРЕБЬНЫИ (8*)	полезный, пригодный
БЛАГОПОХВАЛЕНИѤ (2*)	хвала, восхваление
БЛАГОПОХВАЛЬНЫИ (1*)	хвалебный
БЛАГОПОѨСАНЪ (1*)	тяжеловооруженный
БЛАГОПРАВЬДИѤ (2*)	благопристойность
БЛАГОПРЕБЫВАНbѤ (2*)	правильная, праведная жизнь
БЛАГОПРЕБЫВАНЬНЪ (1*)	благосклонный, благожелательный
БЛАГОПРЕБЫТЬНЪ (1*)	исполненный блага, сопровождаемый благом
БЛАГОПРЕДОУШЬНЫИ (1*)	спокойный
БЛАГОПРИКОСНОВЕНЬНЫИ (1*)	легкодоступный
БЛАГОПРИЛОЖИТИСѦ (1*)	принять как благо
БЛАГОПРИЛОЖЬНО (1*)	подобающим образом
БЛАГОПРИЛѢЖЬНО (1*)	прилежно, усердно
БЛАГОПРИЛѢЖЬНЫИ (1*)	усердный, ревностный к добру, благу
БЛАГОПРИСТОУПЬНЪ (1*)	легкодоступный
БЛАГОПРИЧАСТЬНО (1*)	благоприятно
БЛАГОПРИШЬСТВИѤ (1*)	благодеяние, благие поступки
БЛАГОПРИѨТИ (1*)	принять охотно, с благосклонностью
БЛАГОПРИѨТИѤ (1*)	благосклонное принятие
БЛАГОПРИѨТЫИ (1*)	принятый охотно, с благосклонностью
БЛАГОПРИѨТЬНО (10)	приятно, угодно
БЛАГОПРИѨТЬНЪ (24)	приятный, угодный
БЛАГОПРИѨТЬНѢ (3*)	приятно, благожелательно
БЛАГОПОУТЬНИЦА (1*)	добрая попутчица
БЛАГОРАБОТЬЛИВЪ (1*)	трудолюбивый, услужливый
БЛАГОРАЗСОУДЬНЪ (1*)	рассудительный, предусмотрительный
БЛАГОРАЗСОУЖАТИ (1*)	тщательно разбирать, исследовать что-л., рассуждать о чем-л.
БЛАГОРАЗСОУЖЕНИѤ (2*)	рассудительность, ясность
БЛАГОРАЗТВОРЕНИѤ (1*)	умеренность, благоприятность
БЛАГОРАЗОУМИВЫИ (2*)	благоразумный, рассудительный, предусмотрительный
БЛАГОРАЗОУМИѤ (16)	благоразумие, рассудительность, предусмотрительность, богопознание
БЛАГОРАЗОУМЬНО (6*)	благоразумно, рассудительно, предусмотрительно
БЛАГОРАЗОУМЬНЫИ (21)	благоразумный, рассудительный, предусмотрительный
БЛАГОРАЗОУМЬНѢ (4*)	благоразумно, рассудительно, предусмотрительно
БЛАГОРОДИѤ (18)	знатность, благородное происхождение, духовное благородство, возвышенность души
БЛАГОРОДИТИСѦ (1*)	родиться от знатных родителей, быть знатного происхождения
БЛАГОРОДЬНО (1*)	возвышенно
БЛАГОРОДЬНЫИ (83)	знатный, благородного происхождения
БЛАГОРОДЬНѢИ (7)	более знатный (благородного происхождения)
БЛАГОРОДЬСТВО (20)	знатностъ, благородное происхождение (наружность), духовное благородство, возвышенность души
БЛАГОРОЖЕНЬѤ (1*)	знатность, благородное происхождение
БЛАГОРОУМѦНЬСТВИѤ (2*)	о внешней привлекательности, соблазнительности
БЛАГОРЬВЕНИѤ (1*)	усердие, большое рвение
БЛАГОРѢЧИѤ (1*)	красноречие
БЛАГОСКЪРБЬНЪ (1*)	скорбящий о благе
БЛАГОСЛАВИѤ (3*)	слава, прославление, хвала
БЛАГОСЛОВЕНИѤ (200)	призвание божьей помощи, благодати, благословение, чем благословляют при причащении, часть просфоры
БЛАГОСЛОВЕНЫИ (175)	благословенный, прославленный, восхваленный (о боге)
БЛАГОСЛОВЕСТВЕНИѤ (1*)	благословение, одобрение
БЛАГОСЛОВЕСТИТИ (1*)	призвать божью помощь, благословить, поставить, назначить, одобрить, прославить
БЛАГОСЛОВЕСЬНИКЪ (1*)	богослов
БЛАГОСЛОВЕСЬНЫИ (1*)	божественный
БЛАГОСЛОВИѤ (7)	слава, уважение, восхваление, обращение к духовному лицу, богословие, богословское учение
БЛАГОСЛОВИТИ (549)	призвать божью помощь, благословить, поставить, назначить, одобрить, прославить
БЛАГОСЛОВИТИСѦ (46)	получить благословение, быть прославляемым (восхваляемым)
БЛАГОСЛОВЛЕНИѤ (148)	призвание божьей помощи, благодати, благословение, чем благословляют при причащении, часть просфоры
БЛАГОСЛОВЛЕНЫИ (40)	благословенный, прославленный, восхваленный (о боге)
БЛАГОСЛОВЛѦТИ (29)	призывать божью помощь, благодать, благословлять, прославлять
БЛАГОСЛОВЛѦТИСѦ (2*)	получать благословение
БЛАГОСЛОВЬНЫИ (1*)	достоверный
БЛАГОСЛОВЬСТВОВАТИ (1*)	провозглашать, сообщать радостную весть
БЛАГОСЛОВЬЦЬ (1*)	кто любит вести ученые беседы
БЛАГОСТВЬНЫИ (1*)	исполненный благодати, божественного откровения
БЛАГОСТОѨНИѤ (8*)	твердость, стойкость в благих намерениях, постоянство, установленный порядок, покой
БЛАГОСТОѨНЬНО (1*)	твердо, стойко
БЛАГОСТОѨНЬНЫИ (2*)	твердый, стойкий
БЛАГОСТОѨНЬНѢ (3*)	твердо, стойко
БЛАГОСТРАДАНИѤ (1*)	страдание во имя спасения души
БЛАГОСТРАДАТИ (1*)	претерпевать муки во имя спасения души
БЛАГОСТРАСТЬѤ (1*)	блаженство, наслаждение
БЛАГОСТРОИ (1*)	установление, устроение
БЛАГОСТРОИНЫИ (1*)	поступающий надлежащим образом, следующий установленному порядку
БЛАГОСТЫНИ (85)	доброта, милосердие, благосклонность, духовное совершенство, душевные достоинства, добродетель, благодеяние, доброе дело, добро, духовные блага, блаженство
БЛАГОСТЬ (120)	доброта, милосердие, милость, благо, благодать, добродетель, праведность, душевные достоинства, благополучие, блага (материальные или духовные), блаженство
БЛАГОСТЬНО (3*)	хорошо, добро, бесстрастно (?)
БЛАГОСТЬНЫИ (4*)	добрый, милостивый, милосердный
БЛАГОСТЬСТВОВАТИ (1*)	проявлять милосердие, доброту
БЛАГОСЪБЬРАНИѤ (1*)	полезное объединение, сосредоточение в одном месте
БЛАГОСЪВЬРШЕНЫИ (2*)	скромный, смиренный
БЛАГОСЪВѢСТЬѤ (1*)	истинная сознательность, добрая воля
БЛАГОСЪВѢСТЬНЫИ (2*)	добросовестный, сознательный, добровольный
БЛАГОСЪВѢТОВАТИ (1*)	рассуждать справедливо, давать добрый совет
БЛАГОСЪВѢТЬѤ (1*)	благоразумие, рассудительность
БЛАГОСЪВѢТЬНЪ (2*)	добросовестный, благоразумный
БЛАГОСЪДѢЛАНЬѤ (2*)	благодеяние, совершение добрых дел
БЛАГОСЪЛОЖЕНЬѤ (1*)	упорядочение, стройность, гармоничность
БЛАГОСЪЛОУЧЬНЫИ (1*)	ниспосланный на благо, благодатный
БЛАГОСЪМОТРѢНЬѤ (1*)	благоусмотрение божие, предопределение
БЛАГОСЪМЫСЛЬНЫИ (2*)	благоразумный, мудрый
БЛАГОСЪМѢРЕНЫИ (1*)	кроткий, смиренный, послушный богу
БЛАГОСЪНАБЪДѢТИ (1*)	точно соблюдать, сохранять
БЛАГОСЪСТАВЬНЫИ (1*)	соразмерный, слаженный, гармоничный
БЛАГОСЪТВОРЕНИѤ (1*)	благодеяние, милостыня
БЛАГОСЪЧЬТАНЬНО (1*)	стройно, согласно
БЛАГОСЪЧЬТАНЬНЫИ (4*)	хорошо составленный, слаженный, стройный, гармоничный
БЛАГОСЬРДИѤ (13)	добросердечие, доброта, милосердие
БЛАГОСЬРДЫИ (5*)	добросердечный, милосердный
БЛАГОСЬРДЬНЫИ (1*)	благословенный, праведный
БЛАГОТА (14)	доброта, милость, милосердие, блага (материальные или духовные)
БЛАГОТВОРЕНИѤ (21)	совершение добрых дел, благотворительность, дар, милостыня
БЛАГОТВОРИѤ (7)	добрые дела, милостыня
БЛАГОТВОРИТИ (11*)	делать добро, благодетельствовать, творить на благо
БЛАГОТЕЧЕНИѤ (1*)	подвижнический, праведный образ жизни
БЛАГОТЕЧИ (-ЩИ) (3*)	легко двигаться, вести подвижнический, праведный образ жизни
БЛАГОТИХЫИ (1*)	постоянство, уравновешенность
БЛАГОТИШЬНЫИ (1*)	тихий, спокойный
БЛАГОТОЧЬНЪ (1*)	хорошо текущий, плавный (о речи)
БЛАГОТРЕБЬНЫИ (1*)	служение богу
БЛАГОТЬРПѢТИ (2*)	безропотно сносить, добровольно претерпевать
БЛАГООУВѢТЬНЫИ (1*)	приветливый, благосклонный, снисходительный
БЛАГООУГАЖАТИ (1*)	угождать, быть приятным
БЛАГООУГОДИТИ (2)	угодить, быть приятным
БЛАГООУГОДЬѤ (1*)	расположение, благосклонность
БЛАГООУГОДЬНО (3)	устремленно к благу, добродетельно, покорно, кротко
БЛАГООУГОДЬНЫИ (17)	устремленный к благу, добродетельный, угодный, приятный, желанный
БЛАГООУДОБЬѤ (1*)	нравственное совершенство, добродетель
БЛАГООУДОБЬНО (2*)	на благо, с пользой, благоразумно
БЛАГООУДОБЬНЫИ (1*)	что служит благу, праведное
БЛАГООУДОБЬНѢ (1*)	позволительно, допустимо, не греховно
БЛАГООУКРАШЕНЬѤ (4*)	украшение, нарядное убранство
БЛАГООУМИѤ (11)	благоразумие, благонравие, благожелательность, благоволение, счастье, благополучие
БЛАГООУМИЛЕНЫИ (1*)	смиренный, кроткий
БЛАГООУМИЛЕНЬѤ (1*)	смирение духа, покорность
БЛАГООУМЬНИКЪ (1*)	благоразумный, благонравный человек
БЛАГООУМЬНО (1*)	благоразумно, мудро, благонравно, кротко, покорно
БЛАГООУМЬНЫИ (8)	благоразумный, мудрый, благонравный, кроткий, покорный
БЛАГООУМЬНѢ (1*)	благоразумно, мудро, благонравно, кротко, покорно
БЛАГООУМЬНѢИ (2*)	более благоразумный (мудрый, благонравный, кроткий, покорный)
БЛАГООУМЬСТВО (1*)	мудростъ, здравый ум
БЛАГООУПЛОДИТИ (1*)	изобиловать плодами
БЛАГООУПОВАНИѤ (1*)	упование, добрая надежда
БЛАГООУПРАВЛѦТИСѦ (1*)	следовать правилам, быть послушным
БЛАГООУСТРАѨТИ (1*)	соблюдать порядок, меру
БЛАГООУСТРОѤНИѤ (4*)	должный порядок, упорядоченность, хорошее состояние, благополучие, твердость, стойкость
БЛАГООУСТРОѤНО (1*)	правильно, как следует
БЛАГООУСТРОѤНЫИ (1*)	правильный, устойчивый
БЛАГООУСТРОИТИ (1*)	наставить, направить кого-либо (на правильный путь)
БЛАГООУТВЬРЖЕНЬѤ (1*)	укрепление, упрочение
БЛАГООУХАѤМЪ (1*)	благоуханный
БЛАГООУХАНИѤ (66)	приятный запах, аромат, благоухание, запах сжигаемой жертвы, кадильный дым, жертва, ароматическое вещество, благовоние
БЛАГООУХАНЬНО (2)	распространяюще аромат, ароматно
БЛАГООУХАНЬНЫИ (16)	распространяющий аромат, ароматный
БЛАГООУХАТИ (2*)	распространять аромат, благоухание
БЛАГООУХАТИСѦ (1*)	обонять, воспринимать запах
БЛАГООУЧЕНИѤ (1*)	истинное учение
БЛАГООУЧИНЕНО (1*)	следовательно правилам, дисциплинированно
БЛАГООУЧИНЕНЪ (3*)	следующий правилам, дисциплинированный
БЛАГООУЧИНЕНЬѤ (1*)	строгий порядок, упорядочение
БЛАГОХВАЛЕНИѤ (7)	веселье, ликование, восхваление, прославление, благодарственная хвала
БЛАГОХВАЛИМЪ (1*)	получив благодарственную хвалу	
БЛАГОХВАЛИТИ (2*)	воздавать благодарственную хвалу
БЛАГОХВАЛИТИСѦ (3*)	прославляться, быть хвалимым, заслуживать похвалы
БЛАГОХВАЛЬНИКЪ (1*)	кто воздает хвалу, прославляет
БЛАГОХВАЛЬНО (1*)	ревностно, усердно
БЛАГОХВАЛЬНЫИ (8*)	воздающий хвалу, прославляющий, хвалебный, благолепный, благопристойный, радостный, бодрый духом
БЛАГОХВАЛЬНѢ (3*)	с похвальным усердием
БЛАГОХОДЬНЪ (1*)	удобный для прохождения
БЛАГОХОДЬНѢ (1*)	удобно для прохождения
БЛАГОХОТѢНЬѤ (1*)	благожелательность, благосклонность, благоволение
БЛАГОХРАНИМЫИ (1*)	надежно, прочно сохраняемый, хранимый богом
БЛАГОХОУДОЖЬСТВО (1*)	умение, мастерство, опытность
БЛАГОХОУЛИТИ (1*)	богохульствоволь, порицать бога
БЛАГОЦВѢСТИ (1*)	пышно цвести, процветать
БЛАГОЦВѢТЬНЪ (2*)	пышно цветущий, роскошный
БЛАГОЧАДЬѤ (1*)	удача в детях, родительское счастье, многочисленное потомство
БЛАГОЧАДЬСТВО (1*)	удача в детях, родительское счастье, многочисленное потомство
БЛАГОЧАСТИѤ (1*)	добровольное пожертвование церкви части движимого и недвижимого имущества
БЛАГОЧИНЕНИѤ (3*)	порядок, благоустройство, соблюдение правил, выдержка, послушание
БЛАГОЧИНИѤ (33)	установленный порядок, правила, хорошее состояние, здоровье, соблюдение правил, послушание
БЛАГОЧИНЬНИКЪ (1*)	наставник, поддерживающий должный порядок, благочиние
БЛАГОЧИНЬНО (2*)	следуя правилам, добропорядочно, праведно
БЛАГОЧИНЬНЫИ (5)	следующий правилам, добропорядочный, праведный, соответствующий установленному порядку
БЛАГОЧИНЬСТВО (3*)	следование установленным правилам, послушание
БЛАГОЧИНЬСТИВИѤ (1*)	следование установленному порядку, правилам
БЛАГОЧИСЛЬНЫИ (2*)	удобный для исчисления, легко исчислимый
БЛАГОЧОУВЬСТВЬНЫИ (1*)	сочувственный
БЛАГОЧЬСТВОВАТИ (1*)	быть благочестивым, правоверным, почитать бога
БЛАГОЧЬСТИВИѤ (3*)	благочестие, набожность, почитание бога
БЛАГОЧЬСТИВО (5)	праведно, добродетельно, набожно, соблюдая правила благочестия
БЛАГОЧЬСТИВЫИ (209)	православный, основанный на благочестии, святой, праведный, добродетельный, набожный, соблюдающий правила благочестия
БЛАГОЧЬСТИВЬНО (13)	благочестиво, благоговейно
БЛАГОЧЬСТИВЬНЪ (4)	благочестивый, чтущий бога, воздающий хвалу и честь, хвалебный
БЛАГОЧЬСТИВЬНЪ (1*)	благочестиво, богобоязненно
БЛАГОЧЬСТИВѢ (2*)	благочестиво, богобоязненно, в соответствии с правилами благочестия
БЛАГОЧЬСТИВѢИ (3*)	более праведный (добродетельный, набожный, соблюдающий правила благочестия)
БЛАГОЧЬСТИѤ (340)	правоверие, истинное почитание бога, следование божественным заповедям, праведность, обращение к духовному лицу, установленный порядок, правила
БЛАГОЧЬСТИТИ (1*)	быть благочестивым, чтить бога
БЛАГОЧЬСТЬ (1*)	благочестие, набожность
БЛАГОЧЬСТЬНО (17)	праведно, благочестиво, набожно
БЛАГОЧЬСТЬНЫИ (44)	православный, основанный на благочестии, святой, праведный, добродетельный, набожный, соблюдающий правила благочестия
БЛАГОЧЬСТЬНѢ (13)	благочестиво, праведно, набожно
БЛАГОЧЬСТЬНѢИ (5)	более праведный (добродетельный, набожный, соблюдающий правила благочестия)
БЛАГОЧЬТЕНИѤ (1*)	полезное чтение, чтение священного писания и произведений отцов церкви
БЛАГОЧЬТЬЦЬ (1*)	чтец духовных произведений, поучительной литературы
БЛАГОЩЬ (1*)	вечная жизнь, блаженство
БЛАГОѨВЛЕНЫИ (1*)	благожелательный, независтливый
БЛАГОѨЗЫЧЬНИКЪ (1*)	красноречивый, говорливый человек
БЛАГЫИ (>1000)	хороший, добрый, праведный, святой, приятный, подходящий, пригодный, добро, благо, благодеяние, христианская добродетель, духовное совершенство, блага (материальные или духовные), благоденствие, райское блаженство
БЛАГЫНИ (14)	благо, доброта, добродетель, что служит удовлетворению потребностей, доставляет удовольствие
БЛАЖАИ (11)	лучше, добрей, счастливей, блаженней, блаженство
БЛАЖЕНИѤ (4*)	блаженство, благодать
БЛАЖЕНИКЪ (8)	святой (о покойном святом)
БЛАЖЕНО (7)	счастливо, блаженно
БЛАЖЕНЫИ (1310)	счастливый, блаженный, ведущий к блаженству, счастью, достойный прославления, почитания, святой, блаженный (чаще о святых)
БЛАЖЕНЬНИКЪ (1*)	святой (о покойном святом)
БЛАЖЕНЬНЪ (6)	стихира, читаемая и поющаяся на литургии (по первому слову стиха)
БЛАЖЕНЬСТВО (57)	блаженство, высшее счастье, название одного из евангельских стихов (по его началу), прославление, восхваление, обращение к духовному лицу, царство небесное, рай в загробной жизни
БЛАЖЕНѢИ (21)	счастливей, блаженней
БЛАЖЕСТВЕНЫИ (2*)	блаженный (о некоторых святых)
БЛАЖИИ (3*)	лучше, правильней, счастливей, блаженней
БЛАЖИМЪ (3*)	прославляем, восхваляем, почитаем
БЛАЖИТИ (63)	прославлять, восхвалять, почитать, быть добрым, добросердечным
БЛАЖИТИСѦ (5*)	прославляться, быть восхваляемым, быть добрым
БЛАЗДНЪ	ошибка, заблуждение, соблазн, искушение, обман
БЛАЗНЕНИѤ (1*)	соблазнение, искушение
БЛАЗНИТЕЛЬ (10)	обманщик, кто вводит в заблуждение
БЛАЗНИТИ (11)	соблазнять, искушать, обманывать, отвлекать
БЛАЗНИТИСѦ (32)	ошибаться, заблуждаться, обманываться, сомневаться, прельщаться
БЛАЗНЪ I (38)	ошибка, заблуждение, соблазн, искушение, обман
БЛАЗНЪ II (1*)	ошибочный, ложный
БЛАЗНЬ (15)	ошибка, заблуждение, соблазн, искушение, обман
БЛАЗНЬБА (1*)	ошибочный, ложный
БЛАЗНЬНО (5*)	обманчиво, неверно, опасно, тяжело
БЛАЗНЬНЫИ (13)	обманчивый, обманный, ложный, обольщающий, соблазняющий, вымышленный
БЛАЗНЬНѢ (1*)	обманчиво, неверно, опасно, тяжело
БЛАЗНАТИСѦ (1*)	соблазняться
БЛАЗѢ (11)	хорошо
БЛАТО (12)	болото
БЛАТЬНЫИ (1*)	гадание по движениям членов человеческого тела, биению пульсов
БЛЕДЬ	обман, вздор, ошибка, ересь, обманщик, пустослов, заговорщик
БЛЕКОТАТИ (1*)	блеять
БЛИЖЕНИѤ (2*)	приближение в пространстве, во времени
БЛИЖИИ (32)	ближе (о пространстве, о времени, о родственных, о дружеских отношениях, о сходстве), более близкий
БЛИЖИКА (39)	родственник, родственница, близкий человек
БЛИЖИКЪ (7)	родственник, близкий человек
БЛИЖИТИСѦ (11)	приближаться, приблизиться в пространстве (во времени), становиться, стать ближе в духовном отношении
БЛИЖЬНИИ (410)	близкий, находящийся на небольшом расстоянии, короткий, не дальний, родной, близкий в духовном отношении, человек по отношению к другим людям (согласно христианскому учению)
БЛИЖЬНИКЪ (4*)	родственник, близкий человек
БЛИЖЬНѢ (1*)	близко в духовном отношении
БЛИЗИКЪ (1*)	родственник, близкий человек
БЛИЗИТИСѦ (1*)	стать ближе в духовном отношении
БЛИЗНО (1*)	близко, сходно
БЛИЗНЬЦЬ (13)	близнец, мужские яички
БЛИЗОВАТИ (1*)	находиться рядом, примыкать
БЛИЗОКЪ (12)	родственник, свойственник, близкие, свои люди, ровесники, сверстники
БЛИ3ОЧЬСТВО (19)	свойство
БЛИЗОУ (1*)	вблизи, поблизости
БЛИЗЪ	близко, близок, рядом, скоро, вскоре, близ, подле, возле, около, приблизительно
БЛИЗЬ (374)	близко, близок, рядом, скоро, вскоре, близ, подле, возле, около, приблизительно
БЛИЗЬЦЬ (1*)	родственник, близкий человек
БЛИСКАТИ (1*)	блестеть, сиять
БЛИСКАТИСѦ (1*)	блестеть, сиять
БЛИСТАЛЬНИЦА (1*)	небесное тело, излучающее яркий свет
БЛИСТАНИѤ (18)	блистание, вспышка, блеск (о молнии)
БЛИСТАНИЦА (1*)	небесное тело, излучающее яркий свет
БЛИСТАТИ (11)	блестеть, сиять
БЛИСТАТИСѦ (17)	блестеть, сиять
БЛИЦАНИѤ (1*)	блистание, вспышка, блеск (о молнии)
БЛОУДЕНИѤ (1*)	заблуждение, ересь
БЛОУДИЛИЩЕ (3*)	публичный дом
БЛОУДИТИ (93)	блуждать, скитаться, плутать, заблуждаться, ошибаться, развратничать
БЛОУДИЩЕ (1*)	публичный дом
БЛОУДОДѢѨНИѤ (9)	распутство
БЛОУДОЛЮБЬѤ (1*)	склонность к блуду
БЛОУДОЛЮБЬНЫИ (3*)	склонный к блуду
БЛОУДОЛЮБЬЦЬ (3*)	кто склонен к блуду
БЛОУДОРЕЗЪ? (1*)	(?)
БЛОУДОСЛОВИТИ (1*)	говорить вздор
БЛОУДОТВОРЕНИѤ (1*)	сожительство, незаконный брак
БЛОУДООУБИИЦА (1*)	кто борется с заблуждениями
БЛОУДЪ (316)	заблуждение, ошибка, исповедание ложного учения, разврат, распутство, прелюбодеяние, половые отношения
БЛОУДЬЛИВЪ (1*)	дикий
БЛОУДЬНИКЪ (94)	кто заблуждается, ошибается, исповедует ложное учение, нарушает правила, развратник, прелюбодей
БЛОУДЬНИЦА (131)	развратница, блудница
БЛОУДЬНИЧИЩЬ (1*)	человек рожденный блудницей
БЛОУДЬНИЧЬСКЫИ (7*)	развратнический, прелюбодейский
БЛОУДЬНИЧЬСТВО (1*)	разврат, распутство, прелюбодеяние, половые отношения
БЛОУДЬНО (9*)	безрассудно, бессмысленно, беспутно, расточительно, с излишествами, лживо, распутно, развратно
БЛОУДЬНЫИ (157)	заблуждающийся, развратный, распутный
БЛОУДЬНѢ (1*)	развратно
БЛОУДЬНѢИ (2*)	развратней, распутней
БЛОУДЬСТВО (23)	заблуждение, языческий обряд, разврат, распутство, прелюбодеяние
БЛОУДЬСТВЬНЫИ (1*)	развратный, распутный
БЛОУЖДЕНИѤ (1*)	разврат, распутство
БЛОУЖЕНИѤ (70)	блуждание, скитание, плутание, заблуждение, разврат, распутство
БЛОУЖЬСТВО (1*)	разврат, распутство, прелюбодеяние
БЛЪХА (2*)	блоха
БЛЬВАНЬѤ (1*)	блевотина
БЛЬВАТИ (7)	блевать
БЛЬВОТИНА (11)	блевотина
БЛЬСКЪ (10*)	блеск, сияние, цвет, слава, величие, верхние слои атмосферы
БЛЬСНОУТИ (1*)	блеснуть
БЛЬЩАНИѤ (5*)	блеск, сияние, цвет
БЛЫЩАНОВИДЬНѢ (1*)	ярко
БЛЬЩАТИСѦ (15)	блестеть, сиять, излучать яркий свет, сияние
БЛѢДОСТЬ (4*)	бледность
БЛѢДЪ (7*)	бледный, желтоватый
БЛѢДѢИ (1*)	бледней, желтоватей
БЛЮДЕНИѤ (15)	надзор, покровительство, соблюдение, сохранение, сбережение
БЛЮДО (37)	блюдо, вид сосуда, корзинка
БЛЮДОМЫИ (13)	наблюдаемый, охраняемый, оберегаемый, хранимый
БЛЮДЬЦЕ (2*)	блюдце
БЛЮНОУТИ (1*)	плюнуть
БЛЮСТЕЛЬ (14)	сторож, блюститель, покровитель, защитник, наделенный правами (полномочиями)
БЛЮСТИ (28)	смотреть, следить, наблюдать, соблюдать, сторожитъ, беречь, хранить
БЛЮСТИСѦ (117)	остерегаться, беречься, смотреть
БЛЮСТИТЕЛЬ (1*)	гадатель
БЛѦДЕНИѤ (10*)	вздор, обман, празднословие, разврат, распутство
БЛѦДИВЫИ (15)	вздорный, ошибочный, еретический, развратный
БЛѦДИВЬСТВО (1*)	вздор, обман
БЛѦДОГЛАСИТИ (1*)	говорить вздор, пустословить
БЛѦДООТРОКОВИЧЬСТВИѤ (1*)	растление отроковиц
БЛѦДОСЛОВИѤ (5*)	пустословие, ересь
БЛѦДОСЛОВИТИ (6*)	пустословить, говорить вздор (о еретиках)
БЛѦДОСЛОВО (1*)	неверно, еретически
БЛѦДОСЛОВЬЦЬ (4*)	пустослов, говорящий вздор (обычно о еретиках)
БЛѦДЬ (9*)	обман, вздор, ошибка, ересь, обманщик, пустослов, заговорщик
БЛѦДЬНЫИ (1*)	обманный, вздорный, ошибочный, еретический
БЛѦДЬНѦ (12*)	вздор, обман, ошибка, ересь, распря, разврат
БЛѦДЬСКЫИ (1*)	ошибочный, еретический
БЛѦДЬСТВИѤ (3*)	пустословие, вздор, неверное, еретическое учение
БЛѦДЬСТВО (14*)	обман, ложь, пустословие, разврат, распущенность
БЛѦСТИ (45)	блуждать, плутать, пустословить, болтать нелепости, хулить, говорить вздор (о еретиках), развратничать
БО (~13000)	ведь, так как, ибо, же
БОБРОВИНА (1*)	мясо бобра
БОБРОВЫЙ (4*)	бобровый
БОБРЪ (9)	бобёр, шкурка бобра
БОБЪ (3*)	бобы
БОГАДѢЛЬНЫИ (2*)	живущий в богадельне (при церкви, монастыре)
БОГАТВОРИТИ (1*)	боготворить, поклоняться
БОГАТИИ (1*)	богач
БОГАТИНА (2*)	богач
БОГАТИТИ (15)	обогащать, делать богатым, быть богатым, становиться богатым
БОГАТИТИСА (13)	обогащаться
БОГАТО (1*)	богато
БОГАТОДАВЬЦЬ (2*)	щедрый человек
БОГАТОДАТЕЛЬНЫИ (1*)	много дающий, щедрый
БОГАТОЛЮБЬѤ (1*)	любовь к богатству
БОГАТОУРЪ (1*)	богатырь, витязь
БОГАТЫИ (441)	богатый, щедрый, обильный, роскошный
БОГАТЫРЬ (3*)	богатырь, витязь
БОГАТЬНО (7*)	обильно, щедро
БОГАТЬНЫИ (3*)	обильный, щедрый, пышный, роскошный, дорогой
БОГАТЬНѢ (3*)	обильно, щедро
БОГАТЬСТВИѤ (2*)	богатство
БОГАТЬСТВО (574)	богатство, большое имущество, (духовные) ценности
БОГАТѢ (1*)	обильно, щедро
БОГАТѢИ (27)	богаче
БОГАТѢТИ (31)	богатеть
БОГОБЕЗЧЬСТВОВАТИ (1*)	не почитать, оскорблять бога, богохульствовать
БОГОБЛАГОДАТЬНЫИ (1*)	исполненный божественной благодати
БОГОБЛАЖЕНЫЙ (12)	возвеличенный, благословенный богом, угодный богу
БОГОБЛАЖЕНЬНО (1*)	угодно богу
БОГОБОИНЫИ (9)	богобоязненный
БОГОБОРЬНЫИ (2*)	богоборческий, враждебный богу
БОГОБОРЬЦЬ (5)	богоборец
БОГОБОѨЗНИВЫИ (38)	богобоязненный, набожный, благочестивый
БОГОБОѨЗНЬНЫИ (1*)	богобоязненный, набожный, благочестивый
БОГОБОѨЗНЬСТВО (5*)	богобоязненность, набожность, благочестие
БОГОБОѨЗЬЛИВЫИ (1*)	богобоязненный, набожный, благочестивый
БОГОБОѨНИѤ (1*)	богобоязненность, набожность, благочестие
БОГОВИДИМЪ (2*)	имеющий образ бога, подобный богу
БОГОВИДЬНЫИ (13)	имеющий вид, облик бога, подобный богу
БОГОВИДЬНѢИ (3*)	более подобный богу
