А (>700)	а, но, и, если, хотя
АБИѤ (>300)	сейчас же, тотчас
АВВА (2)	отец
АВГОСТЪ, АВЪГѸСТЪ (23)	Август, август
АВЕЛЪ, АВЕЛЬ (10)	Авель
АВЕСЕЛѸМЪ (1)	Авессалом
АВИАДЪ, АВИДЪ (4)	Авия
АВИАНЬ, АВИѨНЬ (3)	Авиев
АВИАТАРЪ, АВИАТАРЬ (4)	Авиафар
АВИВЪ, АВИВОСЪ, АВИВА (4)	Авив
АВИЛИНИѨ (5)	Авилинея
АВИМЕЛЕХОВЪ  (1)	Авимелехов
АВИРОНЪ (1)	Авирон
АВИТИ, ѨВИТИ (>200)	явить, открыть, сделать явным, обнаружить, показать, объявить, явиться, стать зримым, показаться, появиться, явный, прийти, назначить, оказаться
АВИѸДЪ, АВИЮДЪ (4)	Авиуд
АВЛѨТИ, ѨВЛѨТИ (45)	являть, делать явным, показывать, раскрывать, разоблачать, являться, представать, делаться зримым, представляться, становиться, быть
АВЛѤНИѤ, ѨВЛѤНИѤ (32)	откровение, явление, видение, Богоявление, знамение, знак, нечто явное, очевидное, стать явным, обнаружиться, назначение
АВЛѤНѢ, ѨВЛѤНѢ (1)	явно, открыто
АВОРОВЪ (1)	яворовый
АВРААМЛЬ, АВРАМЛЬ (39)	Авраамов
АВРААМОВЪ, АВРАМОВЪ (3)	Авраамов
АВРААМЪ, АВРАМЪ (80)	Авраам
АВТОНОМЪ (2)	Автоном
АВѢ, ѨВѢ (72)	явно, открыто, ясно, известно, открывать, открыть, выдавать, выдать, наверно, конечно
АГАПИИ (2)	Агапий
АГАРЬ (2)	Агарь
АГАРѢНЕ (1)	агаряне
АГАТОКЛИѨ (1)	Агафоклея
АГАТОНИКЪ (1)	Агафоник
АГАѲОДОРЪ (2)	Агафодор
АГГИИ (1)	Агий
АГЛАИИ (1)	Аглаий
АГНЬЦЬ, ѨГНЬЦЬ (30)	агнец, ягненок
АГНѦ (3)	ягненок, агнец
АГОДА (3)	плод
АГРИКОЛАИ (5)	Агриколай
АГРИПА, АГРИПЪ (2)	Агриппа
АДАВОВЪ (1)	Адавов, Адава
АДАМОВЪ (7)	Адамов
АДАМЪ (47)	Адам
АДИКЪ (1)	Аттик
АДОВЪ (22)	адов, адский
АДОВЬНЪ (2)	адский, адов
АДОВЬСКЪ (3)	адский, адов
АДРИАНЪ (1)	Адриан
АДЪ (76)	ад, пекло
АДЪДИѤВЪ (2)	Аддиев
АДЬСКЪ (4)	адский
АЕРЪ (2)	воздух
АЕРЬНЪ (1)	воздушный
АЕТИИ (1)	Аэтий
АЗАРИѨ (2)	Азария
АЗАРЪ (4)	Азор
АЗЪ (>2700)	я
АИЦЕ (6)	яйцо
АКАКИИ (1)	Акакий
АКРИДЬ (5)	акрида
АКРОГОНИѤИ (1)	краеугольный
АКРОТОМЪ (2)	скала, утес
АКЫ (>100)	как, точно, словно, как будто, в качестве, что
АКѴЛА (1)	Акила
АЛАВАСТРЪ (11)	алебастровый сосуд
АЛАМѸНДАРЬ (1)	Аламундар
АЛАСѴРЬ (?)	Асура
АЛГѸИ (3)	алоэ
АЛГѸИНЪ (3)	из алоэ
АЛЕКСАНДРОВЪ (5)	Александров
АЛЕКСАНДРЬСКЪ (2)	александрийский
АЛЕЛѸИѨ (50)	аллилуйя
АЛЕЛѸИѨРИИ (2)	аллиллуйарий
АЛЕѮАНДРИИСКЪ (1)	александрийский
АЛЕѮАНДРИѨ (5)	Александрия
АЛЕѮАНДРЪ (57)	Александр
АЛСОСЪ (1)	Алсос
АЛФИИ (1)	Алфей
АЛЪДИИ, ЛАДИИ (14)	ладья, корабль
АЛЪКАНИѤ (4)	голод, пост
АЛЪКАТИ, ЛАКАТИ (28)	быть голодным, голодать, поститься
АЛЪНИИ (1)	лань
АЛЪЧЬБА (13)	пост
АЛЪЧЬБЬНЪ (3)	относящийся к посту, связанный с постом
АЛЪЧЬНЪ (1)	быть голодным, голодать
АЛЬФЕОВЪ (10)	Алфеев
АМАЛИКЪ (1)	Амаликитяне
АМАСИИСКЪ (2)	амасийский
АМАСИѨ (1)	Амасия
АМБАКѸМЪ (2)	Аввакум
АМБОНЪ (2)	амвон
АМЕМѸРМНИИ (4)	калиф, халиф
АМЕМѸРМНИИНЪ (2)	халифов
АМЕМѸРМНИНЪ (1)	халиф
АМИДЬСКЪ (1)	Амиды
АМИНАДАВОВЪ (2)	Аминадавов
АМИНАДАВЪ (4)	Аминадав
АМИНЪ, АМИНЬ (>400)	аминь
АМОНЪ (2)	Амон
АМОРИИ (1)	Аморий
АМОРѢИСКЪ (2)	аморрейский
АМОСОВЪ (2)	Амосов
АМОСЪ (4)	Аммос, Амон
АНАВЛЪ (1)	(?)неясно
АНАГНОСТЬСТВО (1)	служба чтеца (в церкви)
АНАЛАВЪ (2)	аналав (часть монашеского облачения)
АНАНИѨ (13)	Анания
АНАСТАСИѨ (2)	Анастасия
АНАТОЛИИ (2)	Анатолий
АНАѮАРХЪ (1)	Анаксарх
АНГЕЛЪ (>300)	ангел, предводитель, князь
АНГЕЛЬСКЪ (36)	ангельский
АНГЕЛЬСКЫ (1)	ангельски
АНИНА, АНИНЪ (8)	Анин
АНКѴРА (2)	якорь
АНКѴУРЬСКЪ (1)	анкирский
АННА (13)	Анна
АНТИГРАФЕѴСЪ (1)	антиграф (контролер государственных доходов)
АНТИМЪ (3)	Анфим
АНТИНОПОЛЬ (3)	Антинополь
АНТИОХИИСКЪ (5)	антиохийский
АНТИОХИѨ (1)	Антиохия
АНТИПАСХА (3)	воскресенье после пасхи
АНТИФОНЪ (9)	антифон
АНТИХРЬСТЪ (1)	антихрист
АНТОНИИ (19)	Антоний
АНТОНИНЪ (26)	Антонин
АНТОНЪ (1)	Антон
АНЬДРЕИ, АНЬДРѢИ, АНЬДРЕѨ, АНЬДРѢѨ (31)	Андрей
АНЬДРЕОВЪ, АНЬДРѢОВЪ, АНЬДРѢѤВЪ (6)	Андреев
АНѲѴПАТЪ (78)	наместник, проконсул
АПАМИИСКЪ (2)	апамийский
АПАМИѨ (1)	Апамия
АПОЛОНИѨ (1)	Аполлония
АПОЛОНОВЪ (3)	Аполлонов
АПОЛОНЪ (8)	Аполлоний
АПОСТОЛА (1)	проповедница христианства
АПОСТОЛЪ (>100)	посол, посланец, апостол
АПОСТОЛЬСКЪ (8)	апостольский, апостолов
АПОСТОЛЬСТВО (1)	апостольство
АПОСТОЛЬСТВОВАТИ (1)	быть апостолом
АПРИЛЬ (8)	апрель
АРАВИИСКЪ (1)	арабский, аравийский
АРАВИѨ (3)	Аравия
АРАВЬСКЪ (2)	арабский, аравийский
АРАМОВЪ (2)	Арамов
АРАМЪ (4)	Арам
АРЕИ (1)	Арес
АРЕОПАГИТЪ (1)	Ареопагит
АРЕТА (1)	Арефа
АРЗАНИНЬСКЪ (1)	арзанийский
АРИАНИ, АРИѨНИ (4)	ариане
АРИАНЬСКЪ, АРИѨНЬСКЪ (4)	арианский
АРИИ, АРИОСЪ (12)	Арий
АРИМАТЕѨ, АРИМАТѢѨ (19)	Ариматея
АРИСТИДЪ (1)	Аристид
АРИѨНЪ (7)	Ариан
АРИѤВЪ (3)	Ариев
АРМЕНИИСКЪ (1)	армянский
АРМЕНИѨ (2)	Армения
АРМЕНЬСКЪ (2)	армянский
АРОМАТЪ (11)	благовоние
АРОНОВЪ, АРѸНОВЪ (3)	Ааронов
АРОНЪ (8)	Аарон
АРОНЬ (9)	Ааронов
АРСАКЪ (1)	Арсакий
АРТАВАНЪ (1)	Артаван
АРТЕМА, АРТЕМИДА (4)	Артемида
АРТЕМИДОВЪ (3)	Артемидин
АРТЕМИИ (1)	Артемий
АРТЕМИСЬ (1)	Артемис
АРТЕМОНЪ (32)	Артемон
АРФАКСАДОВЪ (2)	Арфаксадов
АРХАНГЕЛОВЪ (3)	архангелов, архангельский
АРХАНГЕЛЪ (22)	архангел
АРХАНГЕЛЬСКЪ (2)	архангельский
АРХИДИѨКОНЪ (1)	архидиакон
АРХИЕПИСКѸПЪ, АРХИЕПИСКОПЪ (38)	архиепископ
АРХИЕРЕИ, АРХИЕРѢИ (>200)	первосвященник, архиерей
АРХИЕРЕИСКЪ, АРХИЕРѢИСКЪ (7)	первосвященника, первосвященнический
АРХИЕРЕОВЪ (33)	первосвященника
АРХИЛАИ (3)	Архелай
АРХИСТРАТИГЬ (2)	верховный военачальник
АРХИСѴНАГОГОВЪ (2)	принадлежащий архисинагогу
АРХИСѴНАГОГЬ (12)	архисинагог, глава синагоги
АРХИТРИКЛИНЪ, АРХИТРИКЛИНЪТЪ (9)	распорядитель пира
АРЬНѢИ (2)	Арней
АСАФОВЪ (3)	Асафов
АСАФЪ (1)	Асаф
АСИИСКЪ (2)	азиатский
АСИѨ (3)	Азия
АСИѨНЪ (1)	азиатский
АСКАЛОНЪ (1)	Аскалон
АСКЛИПИИ (4)	Асклепий, Эскулап
АСКЛИПИОДЪ (1)	Асклепиодот
АСКЛИПИѨДЪ, АСКЛИПИАДИ, АСКЛИПИИ (12)	Асклепиад
АСПИДА (3)	змея, гадюка
АСПИДОВЪ (1)	змеиный, гадючий
АССАРИИ (2)	ассарий (мелкая монета)
АСѸРЪ (1)	Ассирия, ассирийцы
АСЪ, АССЪ (4)	Аса
АСѴРИИ (2)	ассириец
АСѴРОВЪ (4)	Асиров
АТАНАИЛЬ (1)	Атанаил
АТИНЫ (1)	Афины
АФЕДРОНЪ (4)	задний проход
АФРИКАНЪ (4)	Африкан
АФРИКИѨ (1)	Африка
АФРИКЬСКЪ (1)	африканский
АХААВЪ (2)	Ахав
АХАЗЪ (4)	Ахаз
АХИЛА (1)	Ахилла
АХИЛИИ (1)	Ахиллий
АХИМЪ, АХИНЪ (4)	Ахим
АХОЛИИ (2)	Ахолий
АЩЕ (>1000)	если, если бы, хотя, что, чтобы, ли, разве, что же если, хоть бы
АЩЕРЪ (1)	ящерица
АЦѢ (3)	между тем, хотя
АШѸТЬ (4)	без причины, напрасно, тщетно
АѲАНАСИИ (3)	Афанасий
АѲИНЕИ (2)	афинянин
АѴДИСОТЪ (1)	Авдиссот
АѴРИЛИѨНЪ (29)	Аврелиан
АѴРИЛИѨНЬ (1)	Аврелианов
БАБА (1)	кормилица
БАГЪРИТИ (1)	багрить
БАГЪРЪ (3)	багрец (краска), багряница, пурпур
БАГЪРѢНИЦА (3)	багряница, пурпур
БАЛИИ (8)	врач
БАЛОВАНИЕ (1)	лечение
БАЛЬСТВО (5)	лекарство, лечение
БАНЬСКЪ (1)	банный, бани
БАНѨ (10)	баня, омовение
БЕДРА (1)	бедро
БЕДРЬНЪ (1)	обильный
БЕЗ (>200)	без, против, вопреки, не по
БЕЗАКОНЕНИѤ, БЕЗАКОНЬНИѤ (71)	беззаконие, проступок
БЕЗАКОНИѤ (53)	нарушение закона, проступок, беззаконие, произвол
БЕЗАКОНЬНИКЪ (21)	кто преступает законы, преступник
БЕЗАКОНЬНОВАТИ (6)	не соблюдать (преступать) законы, совершать беззаконие
БЕЗАКОНЬНЪ (34)	нарушающий законы, незакономерный, негодный, свойственный негодяю, злодейский
БЕЗАКОНЬНѢ (1)	безобразно
БЕЗБОЖЬНЪ (13)	безбожный, безбожник
БЕЗБОЖЬСТВО (1)	безбожие
БЕЗБОѨЗНИѤ (1)	бесстрашие
БЕЗБРАШЬНЪ (1)	еда без пищи
БЕЗБѢДЬНЪ (1)	безопасный
БЕЗВЕЩЬНЪ (3)	невещественный
БЕЗВИНЬНЪ (3)	невинный
БЕЗВОДЬНА (3)	безводная пустыня
БЕЗВОДЬНЪ (7)	безводный, сухой
БЕЗВРѢМЕНЬНЪ (2)	безвременный, вне времени
БЕЗВѢДЬНЪ (1)	тьма невежества
БЕЗВѢРИѤ (1)	безверие, неверие
БЕЗВѢСТЬНЪ (1)	неизвестный, неясный
БЕЗГНѢВЬНЪ (1)	беззлобный
БЕЗГОДИѤ (1)	неблагоприятное время
БЕЗГОДЬНѢ (1)	не вовремя, несвоевременно
БЕЗГРАДЬНИКЪ (1)	человек без родины
БЕЗГРѢШЬНЪ (4)	безгрешный
БЕЗДАРЬСТВЬНЪ (1)	неблагодарный
БЕЗДОБЬ (1)	тщетно, напрасно
БЕЗДРОДЬНЪ (1)	незнатный
БЕЗДРЪПЪТЬНЪ (1)	безропотный
БЕЗДРѢВЬНЪ (1)	не из дерева, недеревянный
БЕЗДѸШЬНЪ (4)	не имеющий души, неживой
БЕЗДЪЖДИѤ (2)	бездождие, засуха
БЕЗДЪНА (17)	пропасть, бездна
БЕЗДЪНИѤ (4)	пропасть, бездна
БЕЗДЪНЪ (4)	бездонный
БЕЗИМЕНЬНЪ (1)	безымянный, неназванный
БЕЗЛѢТЬНЪ (1)	вневременный, нестареющий
БЕЗМИЛОСТИВЪ (1)	немилосердный
БЕМЛЪВИѤ (5)	безмолвие, тишина, монашеский (отшельнический) подвиг молчания
БЕЗМЛЪВЬНЪ (2)	безмолвный, молчаливый
БЕЗМЛЪВЬСТВИѤ (1)	безмолвие, (покорное) молчание
БЕЗМЬЗДЬНИКЪ (2)	бессребреник
БЕЗМѢРЬНЪ (3)	безмерный
БЕЗМѪЖЬНЪ (2)	муж только по названию
БЕЗНАДЕЖДЬНЪ (1)	утративпшй надежду
БЕЗНАЧѦЛЬНО (1)	без начала
БЕЗНАЧѦЛЬНЪ (11)	не имеющий начала
БЕЗОКОВАТИ (1)	быть бесстыдным
БЕЗОЧЬСТВО (5)	бесстыдство
БЕЗѸМАИ (2)	неумный
БЕЗѸМИѤ (27)	неразумность, безрассудство
БЕЗѸМЛЬ, БЕЗѸМЬЛЬ (9)	неразумный, безрассудный
БЕЗѸМЬНИКЪ (1)	неразумный человек
БЕЗѸМЬНЪ (19)	неразумный, безрассудный
БЕЗЪЛОБИВЪ (1)	беззлобный, кроткий, беспорочный
БЕЗЪЛОБИѤ (1)	беззлобность, невиновность
БЕЗЪЛОБЬНЪ (10)	беззлобный, кроткий, беспорочный
БЕЗРАТИИ (1)	мирный, без войны
БЕСВѢТЬНЪ (1)	лишенный света
БЕСКВРЬНЬНЪ (2)	непорочный
БЕСКОНЬЧЬНЪ (4)	бесконечный
БЕСКРЪБЬНЪ (1)	спокойный, мирный, безмятежный
БЕСКРЪВЬНЪ (3)	бескровный
БЕСЛОВЕСЬНЪ (5)	бессловесный (о животных), неразумный
БЕСЛОВЬНЪ (1)	неразумный
БЕСЛЪНЬНЪ (1)	лишенный солнечного света
БЕСПЕЧАЛЬНЪ (2)	беззаботный, спокойный
БЕСПЛАЧЬНЪ (1)	бесслезный, без слез, без плача
БЕСПЛОДЬНЪ (1)	бесплодный, неплодоносящий
БЕСПЛЪТЬНО (1)	бесплотно
БЕСПЛЪТЬНЪ (17)	бесплотный
БЕСПОСАГАИ (1)	незамужний
БЕСПРАВЬДИѤ (1)	несправедливость
БЕСПРАВЬДЬНЪ (1)	несправедливый
БЕСПРИКЛАДЬНЪ (1)	беспримерный, несравненный
БЕСПРѢСТАНИ (5)	беспрестанно, постоянно
БЕСПѪТЬНЪ (1)	бездорожный
БЕСРАМИѤ (3)	бесстыдство
БЕСРАМЪКЪ (1)	бесстыдник
БЕСРАМЬНЪ (1)	бесстыдный
БЕСТРАСТИѤ (2)	отсутствие страданий
БЕСТРАСТЬНЪ (4)	не знающий страданий
БЕСТѸДИѤ (3)	бесстыдство
БЕСТѸДЬНИКЪ (1)	бесстыдник
БЕСТѸДЬНЪ (10)	бесстыдный
БЕСТѸДЬНѢ (1)	бесстыдно
БЕСТѸДЬЦЬ (1)	бесстыдник
БЕСТЬЛѢНИѤ (1)	нетленность
БЕСТЬЛѢНЪ (1)	нетленный
БЕСТЬЛѢНЬНЪ (1)	нетленный
БЕСТѪЖЬНЪ (1)	переносимый без жалоб, безропотный
БЕСХРАМЬНИКЪ (2)	человек без крова
БЕСЪМРЬТИѤ (5)	бессмертие
БЕСЪМРЬТЬНЪ (30)	бессмертный
БЕСЪМРЬТЬСТВО (1)	бессмертие
БЕСЪНИѤ (1)	бдение, бессонница
БЕСѢДА (36)	слово, речь, разговор, манера речи, проповедь
БЕСѢДОВАНИѤ (1)	разговор, беседа
БЕСѢДОВАТИ (50)	беседовать, разговаривать, говорить, общаться, встречаться
БЕЩИНАИ (1)	необузданный, несдержанный
БЕЩИНИѤ (1)	бесчинство, необузданность, несдержанность
БЕЩИНЬНИЦА (1)	бесчинство
БЕЩИНЬНЪ (3)	необузданный, несдержанный
БЕЩИСЛЬНЪ (9)	бесчисленный, безмерный
БЕЩИСМЕНЬНЪ (1)	бесчисленный
БЕЩѸВЬСТВЬНЪ (1)	ничего не чувствующий, не воспринимающий
БЕЩЬСТВИѤ (1)	опозорить
БЕЩЬСТВОВАТИ (2)	срамить, посрамить, бесчестить
БЕЩЬСТВЬНЪ (1)	бесчестный
БЕЩЬСТИИ (2)	непочитаемый, не пользующийся почетом
БЕЩЬСТИѤ (4)	бесчестие, посрамление, опозорить
БЕЩЬСТЬНЪ (4)	посрамленный
БЕЩѦДИѤ (1)	бездетность, бесплодие
БЕЩѦДЬНЪ (5)	бездетный, бесплодный
БЕЦѢНЬНЪ (3)	бесценный, драгоценный
БИВАТИ (1)	убивать
БИСЬРЪ (20)	жемчуг, жемчужина
БИТИ (>100)	бить, бичевать, убивать, забрасывать камнями
БИЧЬ (4)	бич, плетка
БИѤНИѤ (4)	битье, бичевание
БЛАГОВОЛИТИ (18)	благоволить, любить, возлюбить
БЛАГОВОЛѤНИѤ (20)	милость, благоволение
БЛАГОВОЛѤНО (1)	благосклонно
БЛАГОВОНЬНЪ (1)	благовонный, ароматный
БЛАГОВРѢМЕНЬНЪ (2)	своевременный, уместный, удобно, пора
БЛАГОВЪГОДЬНЪ (1)	угодный
БЛАГОВѢРИѤ (7)	набожность, благочестие
БЛАГОВѢРЬНЪ (6)	набожный, благочестивый
БЛАГОВѢРЬНѢ (2)	набожно, благочестиво
БЛАГОВѢСТВОВАТИ (9)	возвещать (добрую весть)
БЛАГОВѢСТИТИ (17)	возвестить, возвещать (добрую весть)
БЛАГОВѢСТОВАТИ (8)	возвещать (добрую весть)
БЛАГОВѢСТЬСТВОВАТИ (9)	возвещать, возвестить (добрую весть)
БЛАГОВѢЩАТИ (3)	возвещать (добрую весть)
БЛАГОВѢЩЕНИѤ (12)	добрая весть, евангелие, благовещение (церковный праздник)
БЛАГОГОЛѢНЬНЪ (1)	имеющий крепкие ноги
БЛАГОДАВЬЦЬ (1)	благодетель
БЛАГОДАРИТИ (9)	благодарить, восхвалять
БЛАГОДАРИѤ (1)	польза, благодеяние
БЛАГОДАРЬСТВИТИ (10)	благодарить, поблагодарить, восхвалять, благодетельствовать, оказывать благодеяние
БЛАГОДАРЬСТВИѤ (2)	благодарственная хвала, благодарение
БЛАГОДАРЬСТВОВАТИ (2)	благодарить, восхвалять
БЛАГОДАРЬСТВЬНЪ (2)	благодарственный, благодатный
БЛАГОДАРѤНИѤ (3)	благодарственная хвала, благодарение
БЛАГОДАТЕЛЬ (1)	благодетель
БЛАГОДАТИ (1)	оказать благодеяние
БЛАГОДАТЬ (24)	милость, благодать
БЛАГОДАТЬНИКЪ (1)	кто делает добро, оказывает милость
БЛАГОДАТЬНЪ (2)	благодатный, исполненный милости
БЛАГОДѸШИѤ (1)	душевное спокойствие
БЛАГОДѢТЕЛЬ (10)	благодетель, кто делает добро, оказывает милость
БЛАГОДѢТЬ (>100)	милость, благодать, благодеяние, добро, благодарение, благодарность, добродетель, приятность
БЛАГОДѢТЬНЪ (9)	благодатный, исполненный милости, милостивый, благотворный, благодарный
БЛАГОДѢѨНИѤ (12)	делание добра, благодеяние
БЛАГОДѢѨТИ (4)	оказывать (оказать) благодеяние, делать (сделать) добро
БЛАГОЖЕ (8)	хорошо, так и надо
БЛАГОИЗВОЛИТИ (12)	возлюбить, любить, благоволить
БЛАГОИЗВОЛЬНЪ (1)	известный, знаменитый
БЛАГОИЗВОЛѤНИѤ (3)	преимущество, добродетель
БЛАГОИСПЫТАНИѤ (1)	старательность
БЛАГОКОРЕНЬНЪ (1)	благородный, хорошего происхождения (рода)
БЛАГОЛѢПЬНЪ (1)	красивый, прекрасный
БЛАГООБРАЗЬНО (1)	добропорядочно
БЛАГООБРАЗЬНЪ (6)	добропорядочный, почтенный
БЛАГОПРИИМИЧЬНЪ (1)	благоприятный, удобный
БЛАГОПРИДЛЕЖЬНЪ (1)	усердный
БЛАГОПРИѨТЬНЪ (1)	угодный, приятный
БЛАГОРАСТВОРѤНИѤ (1)	приятное смешение, соединение
БЛАГОРОДИѤ (1)	благородство
БЛАГОРОДЬНЪ (1)	благородный
БЛАГОСЛОВЕСИТИ (21)	благословить, благословенный, вознести хвалу, восхваленный
БЛАГОСЛОВЕСТВЕНИѤ (5)	благословение
БЛАГОСЛОВЕСТВИТИ (36)	благословить, благословлять, восхвалять
БЛАГОСЛОВЕСТВОВАТИ, БЛАГОСЛОВЕСЬТВОВАТИ (1)	благословлять
БЛАГОСЛОВЕСТВЬНЪ (1)	благословенный, восхваленный
БЛАГОСЛОВЕСТИТИ (18)	благословить, благословлять
БЛАГОСЛОВЕСЬНЪ (2)	благословенный
БЛАГОСЛОВЕСЬСТОВАТИ (1)	благословить
БЛАГОСЛОВЕЩВЛѤНИѤ (1)	благословение
БЛАГОСЛОВЕЩѤНИѤ (4)	благословение
БЛАГОСЛОВЕШѤНИѤ (2)	благословение
БЛАГОСЛОВИТИ (>100)	благословить, благословлять, восхвалить, восхвалять
БЛАГОСЛОВЛѨТИ (3)	благословлять, восхвалять
БЛАГОСЛОВЛѤНИѤ, БЛАГОСЛОВЕНИѤ (28)	благословение
БЛАГОСЛОВЛѤНЪ, БЛАГОСЛОВЕНЪ (31)	благословенный, восхваленный
БЛАГОСТЫНИ (11)	доброта, благожелательность
БЛАГОСТЬ (23)	доброта, милость, благожелательность
БЛАГОСТЬНЪ (1)	добрый, милостивый
